PokerStars Zoom Hand #235752211741: Hold'em No Limit ($025/$050) - 2022/04/26 16:00:10 ET
Table 'C Carinae' 2-max Seat #1 is the button
Seat 1: PrinceViktor ($17137 in chips)
Seat 2: Lorpugo ($2679 in chips)
PrinceViktor: posts small blind $025
Lorpugo: posts big blind $050
*** HOLE CARDS ***
Dealt to Lorpugo [7s 9c]
Dealt to PrinceViktor [5c Jc]
PrinceViktor: raises $075 to $125
Lorpugo: calls $075
*** FLOP *** [5s 6c 2c]
Lorpugo: checks
PrinceViktor: bets $174
Lorpugo: raises $2380 to $2554 and is all-in
PrinceViktor: calls $2380
*** TURN *** [5s 6c 2c] [Jd]
*** RIVER *** [5s 6c 2c Jd] [Qc]
*** SHOW DOWN ***
Lorpugo: shows [7s 9c] (high card Queen)
PrinceViktor: shows [5c Jc] (a flush, Queen high)
PrinceViktor collected $5264 from pot
*** SUMMARY ***
Total pot $5358 | Rake $094
Board [5s 6c 2c Jd Qc]
Seat 1: PrinceViktor (button) (small blind) showed [5c Jc] and won ($52 64) with a flush, Queen high
Seat 2: Lorpugo (big blind) showed [7s 9c] and lost with high card Queen


*********** # 2 **************
PokerStars Zoom Hand #235752209560: Hold'em No Limit ($025/$050) - 2022/04/26 16:00:03 ET
Table 'C Carinae' 2-max Seat #1 is the button
Seat 1: Lorpugo ($2704 in chips)
Seat 2: iulian3000 ($30 in chips)
Lorpugo: posts small blind $025
iulian3000: posts big blind $050
*** HOLE CARDS ***
Dealt to Lorpugo [3s 6c]
Lorpugo: folds
Uncalled bet ($025) returned to iulian3000
iulian3000 collected $050 from pot
iulian3000: doesn't show hand
*** SUMMARY ***
Total pot $050 | Rake $0
Seat 1: Lorpugo (button) (small blind) folded before Flop
Seat 2: iulian3000 (big blind) collected ($050)


*********** # 3 **************
PokerStars Zoom Hand #235752207144: Hold'em No Limit ($025/$050) - 2022/04/26 15:59:55 ET
Table 'C Carinae' 2-max Seat #1 is the button
Seat 1: RioRin ($6971 in chips)
Seat 2: Lorpugo ($2754 in chips)
RioRin: posts small blind $025
Lorpugo: posts big blind $050
*** HOLE CARDS ***
Dealt to Lorpugo [5c 3s]
RioRin: raises $1 to $150
Lorpugo: folds
Uncalled bet ($1) returned to RioRin
RioRin collected $1 from pot
RioRin: doesn't show hand
*** SUMMARY ***
Total pot $1 | Rake $0
Seat 1: RioRin (button) (small blind) collected ($1)
Seat 2: Lorpugo (big blind) folded before Flop


*********** # 4 **************
PokerStars Zoom Hand #235752154474: Hold'em No Limit ($025/$050) - 2022/04/26 15:57:04 ET
Table 'C Carinae' 2-max Seat #1 is the button
Seat 1: Lorpugo ($2923 in chips)
Seat 2: 3bet4win9 ($3390 in chips)
Lorpugo: posts small blind $025
3bet4win9: posts big blind $050
*** HOLE CARDS ***
Dealt to Lorpugo [5h 5s]
Dealt to 3bet4win9 [Kd Ks]
Lorpugo: raises $050 to $1
3bet4win9: raises $1 to $2
Lorpugo: calls $1
*** FLOP *** [2s 9d 3d]
3bet4win9: bets $190
Lorpugo: raises $2533 to $2723 and is all-in
3bet4win9: calls $2533
*** TURN *** [2s 9d 3d] [7d]
*** RIVER *** [2s 9d 3d 7d] [6d]
*** SHOW DOWN ***
3bet4win9: shows [Kd Ks] (a flush, King high)
Lorpugo: shows [5h 5s] (a pair of Fives)
3bet4win9 collected $5771 from pot
*** SUMMARY ***
Total pot $5846 | Rake $075
Board [2s 9d 3d 7d 6d]
Seat 1: Lorpugo (button) (small blind) showed [5h 5s] and lost with a pair of Fives
Seat 2: 3bet4win9 (big blind) showed [Kd Ks] and won ($5771) with a flush, King high


*********** # 5 **************
PokerStars Zoom Hand #235752152296: Hold'em No Limit ($025/$050) - 2022/04/26 15:56:56 ET
Table 'C Carinae' 2-max Seat #1 is the button
Seat 1: morozo33 ($5093 in chips)
Seat 2: Lorpugo ($2898 in chips)
morozo33: posts small blind $025
Lorpugo: posts big blind $050
*** HOLE CARDS ***
Dealt to Lorpugo [9c 5d]
morozo33: folds
Uncalled bet ($025) returned to Lorpugo
Lorpugo collected $050 from pot
Lorpugo: doesn't show hand
*** SUMMARY ***
Total pot $050 | Rake $0
Seat 1: morozo33 (button) (small blind) folded before Flop
Seat 2: Lorpugo (big blind) collected ($050)


*********** # 6 **************
PokerStars Zoom Hand #235752150524: Hold'em No Limit ($025/$050) - 2022/04/26 15:56:50 ET
Table 'C Carinae' 2-max Seat #1 is the button
Seat 1: Lorpugo ($2923 in chips)
Seat 2: TheBluffPL ($51 in chips)
Lorpugo: posts small blind $025
TheBluffPL: posts big blind $050
*** HOLE CARDS ***
Dealt to Lorpugo [Js 3d]
Lorpugo: folds
Uncalled bet ($025) returned to TheBluffPL
TheBluffPL collected $050 from pot
TheBluffPL: doesn't show hand
*** SUMMARY ***
Total pot $050 | Rake $0
Seat 1: Lorpugo (button) (small blind) folded before Flop
Seat 2: TheBluffPL (big blind) collected ($050)


*********** # 7 **************
PokerStars Zoom Hand #235752141307: Hold'em No Limit ($025/$050) - 2022/04/26 15:56:20 ET
Table 'C Carinae' 2-max Seat #1 is the button
Seat 1: Lorpugo ($2644 in chips)
Seat 2: numbernine5 ($7206 in chips)
Lorpugo: posts small blind $025
numbernine5: posts big blind $050
*** HOLE CARDS ***
Dealt to Lorpugo [6s 4c]
Dealt to numbernine5 [9c As]
Lorpugo: raises $050 to $1
numbernine5: calls $050
*** FLOP *** [Qs Qd Kh]
numbernine5: checks
Lorpugo: bets $060
numbernine5: calls $060
*** TURN *** [Qs Qd Kh] [7s]
numbernine5: checks
Lorpugo: checks
*** RIVER *** [Qs Qd Kh 7s] [4s]
numbernine5: bets $150
Lorpugo: calls $150
*** SHOW DOWN ***
numbernine5: shows [9c As] (a pair of Queens)
Lorpugo: shows [6s 4c] (two pair, Queens and Fours)
Lorpugo collected $589 from pot
*** SUMMARY ***
Total pot $620 | Rake $031
Board [Qs Qd Kh 7s 4s]
Seat 1: Lorpugo (button) (small blind) showed [6s 4c] and won ($589) with two pair, Queens and Fours
Seat 2: numbernine5 (big blind) showed [9c As] and lost with a pair of Queens


*********** # 8 **************
PokerStars Zoom Hand #235752135680: Hold'em No Limit ($025/$050) - 2022/04/26 15:56:01 ET
Table 'C Carinae' 2-max Seat #1 is the button
Seat 1: Dougpolk27997 ($5351 in chips)
Seat 2: Lorpugo ($2769 in chips)
Dougpolk27997: posts small blind $025
Lorpugo: posts big blind $050
*** HOLE CARDS ***
Dealt to Lorpugo [Tc 3c]
Dougpolk27997: raises $075 to $125
Lorpugo: calls $075
*** FLOP *** [7h Jd 2s]
Lorpugo: checks
Dougpolk27997: bets $071
Lorpugo: folds
Uncalled bet ($071) returned to Dougpolk27997
Dougpolk27997 collected $238 from pot
Dougpolk27997: doesn't show hand
*** SUMMARY ***
Total pot $250 | Rake $012
Board [7h Jd 2s]
Seat 1: Dougpolk27997 (button) (small blind) collected ($238)
Seat 2: Lorpugo (big blind) folded on the Flop


*********** # 9 **************
PokerStars Zoom Hand #235752133041: Hold'em No Limit ($025/$050) - 2022/04/26 15:55:52 ET
Table 'C Carinae' 2-max Seat #1 is the button
Seat 1: 3bet4win9 ($2530 in chips)
Seat 2: Lorpugo ($2819 in chips)
3bet4win9: posts small blind $025
Lorpugo: posts big blind $050
*** HOLE CARDS ***
Dealt to Lorpugo [4d 6s]
3bet4win9: raises $1 to $150
Lorpugo: folds
Uncalled bet ($1) returned to 3bet4win9
3bet4win9 collected $1 from pot
3bet4win9: doesn't show hand
*** SUMMARY ***
Total pot $1 | Rake $0
Seat 1: 3bet4win9 (button) (small blind) collected ($1)
Seat 2: Lorpugo (big blind) folded before Flop


*********** # 10 **************
PokerStars Zoom Hand #235752128836: Hold'em No Limit ($025/$050) - 2022/04/26 15:55:38 ET
Table 'C Carinae' 2-max Seat #1 is the button
Seat 1: Lorpugo ($2769 in chips)
Seat 2: PrinceViktor ($13396 in chips)
Lorpugo: posts small blind $025
PrinceViktor: posts big blind $050
*** HOLE CARDS ***
Dealt to Lorpugo [7s Ah]
Lorpugo: raises $075 to $125
PrinceViktor: folds
Uncalled bet ($075) returned to Lorpugo
Lorpugo collected $1 from pot
Lorpugo: doesn't show hand
*** SUMMARY ***
Total pot $1 | Rake $0
Seat 1: Lorpugo (button) (small blind) collected ($1)
Seat 2: PrinceViktor (big blind) folded before Flop


*********** # 11 **************
PokerStars Zoom Hand #235752125284: Hold'em No Limit ($025/$050) - 2022/04/26 15:55:26 ET
Table 'C Carinae' 2-max Seat #1 is the button
Seat 1: PrinceViktor ($13346 in chips)
Seat 2: Lorpugo ($2819 in chips)
PrinceViktor: posts small blind $025
Lorpugo: posts big blind $050
*** HOLE CARDS ***
Dealt to Lorpugo [9c 3h]
PrinceViktor: raises $075 to $125
Lorpugo: folds
Uncalled bet ($075) returned to PrinceViktor
PrinceViktor collected $1 from pot
PrinceViktor: doesn't show hand
*** SUMMARY ***
Total pot $1 | Rake $0
Seat 1: PrinceViktor (button) (small blind) collected ($1)
Seat 2: Lorpugo (big blind) folded before Flop


*********** # 12 **************
PokerStars Zoom Hand #235752119980: Hold'em No Limit ($025/$050) - 2022/04/26 15:55:10 ET
Table 'C Carinae' 2-max Seat #1 is the button
Seat 1: Lorpugo ($2729 in chips)
Seat 2: drchilled ($6824 in chips)
Lorpugo: posts small blind $025
drchilled: posts big blind $050
*** HOLE CARDS ***
Dealt to Lorpugo [9d 5h]
Lorpugo: raises $050 to $1
drchilled: calls $050
*** FLOP *** [8d 7c Ad]
drchilled: checks
Lorpugo: bets $063
drchilled: folds
Uncalled bet ($063) returned to Lorpugo
Lorpugo collected $190 from pot
Lorpugo: doesn't show hand
drchilled is disconnected
*** SUMMARY ***
Total pot $2 | Rake $010
Board [8d 7c Ad]
Seat 1: Lorpugo (button) (small blind) collected ($190)
Seat 2: drchilled (big blind) folded on the Flop


*********** # 13 **************
PokerStars Zoom Hand #235752111609: Hold'em No Limit ($025/$050) - 2022/04/26 15:54:49 ET
Table 'C Carinae' 2-max Seat #1 is the button
Seat 1: iulian3000 ($4949 in chips)
Seat 2: Lorpugo ($2684 in chips)
iulian3000: posts small blind $025
Lorpugo: posts big blind $050
*** HOLE CARDS ***
Dealt to Lorpugo [2d Jc]
iulian3000: calls $025
Lorpugo: checks
*** FLOP *** [Qd Th 4s]
Lorpugo: checks
iulian3000: checks
*** TURN *** [Qd Th 4s] [Ts]
Lorpugo: bets $050
iulian3000: folds
Uncalled bet ($050) returned to Lorpugo
Lorpugo collected $095 from pot
Lorpugo: doesn't show hand
*** SUMMARY ***
Total pot $1 | Rake $005
Board [Qd Th 4s Ts]
Seat 1: iulian3000 (button) (small blind) folded on the Turn
Seat 2: Lorpugo (big blind) collected ($095)


*********** # 14 **************
PokerStars Zoom Hand #235752103806: Hold'em No Limit ($025/$050) - 2022/04/26 15:54:29 ET
Table 'C Carinae' 2-max Seat #1 is the button
Seat 1: Lorpugo ($2884 in chips)
Seat 2: iulian3000 ($4769 in chips)
Lorpugo: posts small blind $025
iulian3000: posts big blind $050
*** HOLE CARDS ***
Dealt to Lorpugo [4h 8h]
Lorpugo: raises $050 to $1
iulian3000: raises $1 to $2
Lorpugo: calls $1
*** FLOP *** [6c Jd Td]
iulian3000: bets $2
Lorpugo: folds
Uncalled bet ($2) returned to iulian3000
iulian3000 collected $380 from pot
iulian3000: doesn't show hand
*** SUMMARY ***
Total pot $4 | Rake $020
Board [6c Jd Td]
Seat 1: Lorpugo (button) (small blind) folded on the Flop
Seat 2: iulian3000 (big blind) collected ($380)


*********** # 15 **************
PokerStars Zoom Hand #235752100425: Hold'em No Limit ($025/$050) - 2022/04/26 15:54:21 ET
Table 'C Carinae' 2-max Seat #1 is the button
Seat 1: Dougpolk27997 ($5325 in chips)
Seat 2: Lorpugo ($2934 in chips)
Dougpolk27997: posts small blind $025
Lorpugo: posts big blind $050
*** HOLE CARDS ***
Dealt to Lorpugo [2d Kc]
Dougpolk27997: raises $075 to $125
Lorpugo: folds
Uncalled bet ($075) returned to Dougpolk27997
Dougpolk27997 collected $1 from pot
Dougpolk27997: doesn't show hand
*** SUMMARY ***
Total pot $1 | Rake $0
Seat 1: Dougpolk27997 (button) (small blind) collected ($1)
Seat 2: Lorpugo (big blind) folded before Flop


*********** # 16 **************
PokerStars Zoom Hand #235752095011: Hold'em No Limit ($025/$050) - 2022/04/26 15:54:07 ET
Table 'C Carinae' 2-max Seat #1 is the button
Seat 1: Lorpugo ($3034 in chips)
Seat 2: Dougpolk27997 ($5225 in chips)
Lorpugo: posts small blind $025
Dougpolk27997: posts big blind $050
*** HOLE CARDS ***
Dealt to Lorpugo [Td 6c]
Lorpugo: raises $050 to $1
Dougpolk27997: raises $4 to $5
Lorpugo: folds
Uncalled bet ($4) returned to Dougpolk27997
Dougpolk27997 collected $2 from pot
Dougpolk27997: doesn't show hand
*** SUMMARY ***
Total pot $2 | Rake $0
Seat 1: Lorpugo (button) (small blind) folded before Flop
Seat 2: Dougpolk27997 (big blind) collected ($2)


*********** # 17 **************
PokerStars Zoom Hand #235752080138: Hold'em No Limit ($025/$050) - 2022/04/26 15:53:29 ET
Table 'C Carinae' 2-max Seat #1 is the button
Seat 1: PrinceViktor ($15548 in chips)
Seat 2: Lorpugo ($3238 in chips)
PrinceViktor: posts small blind $025
Lorpugo: posts big blind $050
*** HOLE CARDS ***
Dealt to Lorpugo [9d Jd]
PrinceViktor: raises $075 to $125
Lorpugo: calls $075
*** FLOP *** [Qc 7h 5d]
Lorpugo: checks
PrinceViktor: bets $079
Lorpugo: calls $079
*** TURN *** [Qc 7h 5d] [2c]
Lorpugo: checks
PrinceViktor: bets $524
Lorpugo: folds
Uncalled bet ($524) returned to PrinceViktor
PrinceViktor collected $383 from pot
PrinceViktor: doesn't show hand
*** SUMMARY ***
Total pot $408 | Rake $025
Board [Qc 7h 5d 2c]
Seat 1: PrinceViktor (button) (small blind) collected ($383)
Seat 2: Lorpugo (big blind) folded on the Turn


*********** # 18 **************
PokerStars Zoom Hand #235752077032: Hold'em No Limit ($025/$050) - 2022/04/26 15:53:21 ET
Table 'C Carinae' 2-max Seat #1 is the button
Seat 1: Lorpugo ($3188 in chips)
Seat 2: morozo33 ($5953 in chips)
Lorpugo: posts small blind $025
morozo33: posts big blind $050
*** HOLE CARDS ***
Dealt to Lorpugo [Ks Qs]
Lorpugo: raises $075 to $125
morozo33: folds
Uncalled bet ($075) returned to Lorpugo
Lorpugo collected $1 from pot
Lorpugo: doesn't show hand
*** SUMMARY ***
Total pot $1 | Rake $0
Seat 1: Lorpugo (button) (small blind) collected ($1)
Seat 2: morozo33 (big blind) folded before Flop


*********** # 19 **************
PokerStars Zoom Hand #235752071518: Hold'em No Limit ($025/$050) - 2022/04/26 15:53:07 ET
Table 'C Carinae' 2-max Seat #1 is the button
Seat 1: Lorpugo ($3138 in chips)
Seat 2: PrinceViktor ($15723 in chips)
Lorpugo: posts small blind $025
PrinceViktor: posts big blind $050
*** HOLE CARDS ***
Dealt to Lorpugo [Kc 5c]
Lorpugo: raises $075 to $125
PrinceViktor: folds
Uncalled bet ($075) returned to Lorpugo
Lorpugo collected $1 from pot
Lorpugo: doesn't show hand
*** SUMMARY ***
Total pot $1 | Rake $0
Seat 1: Lorpugo (button) (small blind) collected ($1)
Seat 2: PrinceViktor (big blind) folded before Flop


*********** # 20 **************
PokerStars Zoom Hand #235752067299: Hold'em No Limit ($025/$050) - 2022/04/26 15:52:56 ET
Table 'C Carinae' 2-max Seat #1 is the button
Seat 1: PrinceViktor ($15673 in chips)
Seat 2: Lorpugo ($3188 in chips)
PrinceViktor: posts small blind $025
Lorpugo: posts big blind $050
*** HOLE CARDS ***
Dealt to Lorpugo [Td 2h]
PrinceViktor: raises $050 to $1
Lorpugo: folds
Uncalled bet ($050) returned to PrinceViktor
PrinceViktor collected $1 from pot
PrinceViktor: doesn't show hand
*** SUMMARY ***
Total pot $1 | Rake $0
Seat 1: PrinceViktor (button) (small blind) collected ($1)
Seat 2: Lorpugo (big blind) folded before Flop


*********** # 21 **************
PokerStars Zoom Hand #235752063915: Hold'em No Limit ($025/$050) - 2022/04/26 15:52:47 ET
Table 'C Carinae' 2-max Seat #1 is the button
Seat 1: ProChris94 ($5181 in chips)
Seat 2: Lorpugo ($3238 in chips)
ProChris94: posts small blind $025
Lorpugo: posts big blind $050
*** HOLE CARDS ***
Dealt to Lorpugo [2s Kc]
ProChris94: raises $1 to $150
Lorpugo: folds
Uncalled bet ($1) returned to ProChris94
ProChris94 collected $1 from pot
ProChris94: doesn't show hand
*** SUMMARY ***
Total pot $1 | Rake $0
Seat 1: ProChris94 (button) (small blind) collected ($1)
Seat 2: Lorpugo (big blind) folded before Flop


*********** # 22 **************
PokerStars Zoom Hand #235752053651: Hold'em No Limit ($025/$050) - 2022/04/26 15:52:21 ET
Table 'C Carinae' 2-max Seat #1 is the button
Seat 1: Lorpugo ($3125 in chips)
Seat 2: GerryBon ($3512 in chips)
Lorpugo: posts small blind $025
GerryBon: posts big blind $050
*** HOLE CARDS ***
Dealt to Lorpugo [9d 7d]
Lorpugo: raises $075 to $125
GerryBon: calls $075
*** FLOP *** [3d 6h Kc]
GerryBon: checks
Lorpugo: bets $079
GerryBon: folds
Uncalled bet ($079) returned to Lorpugo
Lorpugo collected $238 from pot
Lorpugo: doesn't show hand
GerryBon is disconnected
*** SUMMARY ***
Total pot $250 | Rake $012
Board [3d 6h Kc]
Seat 1: Lorpugo (button) (small blind) collected ($238)
Seat 2: GerryBon (big blind) folded on the Flop


*********** # 23 **************
PokerStars Zoom Hand #235752050087: Hold'em No Limit ($025/$050) - 2022/04/26 15:52:11 ET
Table 'C Carinae' 2-max Seat #1 is the button
Seat 1: Lorpugo ($3075 in chips)
Seat 2: BRoGeRZ ($5472 in chips)
Lorpugo: posts small blind $025
BRoGeRZ: posts big blind $050
*** HOLE CARDS ***
Dealt to Lorpugo [Jh Qd]
Lorpugo: raises $075 to $125
BRoGeRZ: folds
Uncalled bet ($075) returned to Lorpugo
Lorpugo collected $1 from pot
Lorpugo: doesn't show hand
*** SUMMARY ***
Total pot $1 | Rake $0
Seat 1: Lorpugo (button) (small blind) collected ($1)
Seat 2: BRoGeRZ (big blind) folded before Flop


*********** # 24 **************
PokerStars Zoom Hand #235752047268: Hold'em No Limit ($025/$050) - 2022/04/26 15:52:04 ET
Table 'C Carinae' 2-max Seat #1 is the button
Seat 1: TilTandWiN ($8673 in chips)
Seat 2: Lorpugo ($3125 in chips)
TilTandWiN: posts small blind $025
Lorpugo: posts big blind $050
*** HOLE CARDS ***
Dealt to Lorpugo [Ts 2h]
TilTandWiN: raises $060 to $110
Lorpugo: folds
Uncalled bet ($060) returned to TilTandWiN
TilTandWiN collected $1 from pot
TilTandWiN: doesn't show hand
*** SUMMARY ***
Total pot $1 | Rake $0
Seat 1: TilTandWiN (button) (small blind) collected ($1)
Seat 2: Lorpugo (big blind) folded before Flop


*********** # 25 **************
PokerStars Zoom Hand #235752040143: Hold'em No Limit ($025/$050) - 2022/04/26 15:51:46 ET
Table 'C Carinae' 2-max Seat #1 is the button
Seat 1: iulian3000 ($3732 in chips)
Seat 2: Lorpugo ($3080 in chips)
iulian3000: posts small blind $025
Lorpugo: posts big blind $050
*** HOLE CARDS ***
Dealt to Lorpugo [3s 7s]
iulian3000: calls $025
Lorpugo: checks
*** FLOP *** [4h Qh 3d]
Lorpugo: bets $050
iulian3000: folds
Uncalled bet ($050) returned to Lorpugo
Lorpugo collected $095 from pot
Lorpugo: doesn't show hand
*** SUMMARY ***
Total pot $1 | Rake $005
Board [4h Qh 3d]
Seat 1: iulian3000 (button) (small blind) folded on the Flop
Seat 2: Lorpugo (big blind) collected ($095)


*********** # 26 **************
PokerStars Zoom Hand #235752027633: Hold'em No Limit ($025/$050) - 2022/04/26 15:51:14 ET
Table 'C Carinae' 2-max Seat #1 is the button
Seat 1: iulian3000 ($2743 in chips)
Seat 2: Lorpugo ($4144 in chips)
iulian3000: posts small blind $025
Lorpugo: posts big blind $050
*** HOLE CARDS ***
Dealt to Lorpugo [Jd Kh]
Dealt to iulian3000 [9c 8s]
iulian3000: calls $025
Lorpugo: raises $125 to $175
iulian3000: calls $125
*** FLOP *** [5d 2d 8c]
Lorpugo: bets $110
iulian3000: calls $110
*** TURN *** [5d 2d 8c] [2h]
Lorpugo: bets $179
iulian3000: calls $179
*** RIVER *** [5d 2d 8c 2h] [Qc]
Lorpugo: bets $6
iulian3000: calls $6
*** SHOW DOWN ***
Lorpugo: shows [Jd Kh] (a pair of Deuces)
iulian3000: shows [9c 8s] (two pair, Eights and Deuces)
iulian3000 collected $2053 from pot
*** SUMMARY ***
Total pot $2128 | Rake $075
Board [5d 2d 8c 2h Qc]
Seat 1: iulian3000 (button) (small blind) showed [9c 8s] and won ($2053) with two pair, Eights and Deuces
Seat 2: Lorpugo (big blind) showed [Jd Kh] and lost with a pair of Deuces


*********** # 27 **************
PokerStars Zoom Hand #235752025436: Hold'em No Limit ($025/$050) - 2022/04/26 15:51:08 ET
Table 'C Carinae' 2-max Seat #1 is the button
Seat 1: Lorpugo ($4169 in chips)
Seat 2: GerryBon ($3487 in chips)
Lorpugo: posts small blind $025
GerryBon: posts big blind $050
*** HOLE CARDS ***
Dealt to Lorpugo [6s Jc]
Lorpugo: folds
Uncalled bet ($025) returned to GerryBon
GerryBon collected $050 from pot
GerryBon: doesn't show hand
*** SUMMARY ***
Total pot $050 | Rake $0
Seat 1: Lorpugo (button) (small blind) folded before Flop
Seat 2: GerryBon (big blind) collected ($050)


*********** # 28 **************
PokerStars Zoom Hand #235752021415: Hold'em No Limit ($025/$050) - 2022/04/26 15:50:58 ET
Table 'C Carinae' 2-max Seat #1 is the button
Seat 1: Lorpugo ($4194 in chips)
Seat 2: scirocco994 ($10531 in chips)
Lorpugo: posts small blind $025
scirocco994: posts big blind $050
*** HOLE CARDS ***
Dealt to Lorpugo [2s Qc]
Lorpugo: folds
Uncalled bet ($025) returned to scirocco994
scirocco994 collected $050 from pot
scirocco994: doesn't show hand
*** SUMMARY ***
Total pot $050 | Rake $0
Seat 1: Lorpugo (button) (small blind) folded before Flop
Seat 2: scirocco994 (big blind) collected ($050)


*********** # 29 **************
PokerStars Zoom Hand #235752014342: Hold'em No Limit ($025/$050) - 2022/04/26 15:50:50 ET
Table 'C Carinae' 2-max Seat #1 is the button
Seat 1: numbernine5 ($5125 in chips)
Seat 2: Lorpugo ($4169 in chips)
numbernine5: posts small blind $025
Lorpugo: posts big blind $050
*** HOLE CARDS ***
Dealt to Lorpugo [5c 9s]
numbernine5: folds
Uncalled bet ($025) returned to Lorpugo
Lorpugo collected $050 from pot
Lorpugo: doesn't show hand
*** SUMMARY ***
Total pot $050 | Rake $0
Seat 1: numbernine5 (button) (small blind) folded before Flop
Seat 2: Lorpugo (big blind) collected ($050)


*********** # 30 **************
PokerStars Zoom Hand #235751923904: Hold'em No Limit ($025/$050) - 2022/04/26 15:46:54 ET
Table 'C Carinae' 2-max Seat #1 is the button
Seat 1: PrinceViktor ($7441 in chips)
Seat 2: Lorpugo ($3270 in chips)
PrinceViktor: posts small blind $025
Lorpugo: posts big blind $050
*** HOLE CARDS ***
Dealt to Lorpugo [Kd Qh]
Dealt to PrinceViktor [9s Ad]
PrinceViktor: raises $075 to $125
Lorpugo: raises $275 to $400
PrinceViktor: calls $275
*** FLOP *** [Td Jc 4d]
Lorpugo: bets $380
PrinceViktor: calls $380
*** TURN *** [Td Jc 4d] [Qd]
Lorpugo: bets $900
PrinceViktor: raises $4435 to $5335
Lorpugo: calls $1590 and is all-in
Uncalled bet ($2845) returned to PrinceViktor
*** RIVER *** [2d]
Lorpugo: checks fuck
*** SHOW DOWN ***
Lorpugo: shows [Kd Qh] (a flush, King high)
PrinceViktor: shows [9s Ad] (a flush, Ace high)
PrinceViktor collected $6446 from pot
*** SUMMARY ***
Total pot $6540 | Rake $094
Board [Td Jc 4d Qd 2d]
Seat 1: PrinceViktor (button) (small blind) showed [9s Ad] and won ($6446) with a flush, Ace high
Seat 2: Lorpugo (big blind) showed [Kd Qh] and lost with a flush, King high


*********** # 31 **************
PokerStars Zoom Hand #235751920825: Hold'em No Limit ($025/$050) - 2022/04/26 15:46:46 ET
Table 'C Carinae' 2-max Seat #1 is the button
Seat 1: Lorpugo ($3220 in chips)
Seat 2: iulian3000 ($3915 in chips)
Lorpugo: posts small blind $025
iulian3000: posts big blind $050
*** HOLE CARDS ***
Dealt to Lorpugo [9c Qh]
Lorpugo: raises $075 to $125
iulian3000: folds
Uncalled bet ($075) returned to Lorpugo
Lorpugo collected $1 from pot
Lorpugo: doesn't show hand
*** SUMMARY ***
Total pot $1 | Rake $0
Seat 1: Lorpugo (button) (small blind) collected ($1)
Seat 2: iulian3000 (big blind) folded before Flop


*********** # 32 **************
PokerStars Zoom Hand #235751905728: Hold'em No Limit ($025/$050) - 2022/04/26 15:46:07 ET
Table 'C Carinae' 2-max Seat #1 is the button
Seat 1: PrinceViktor ($9301 in chips)
Seat 2: Lorpugo ($2703 in chips)
PrinceViktor: posts small blind $025
Lorpugo: posts big blind $050
*** HOLE CARDS ***
Dealt to Lorpugo [Qd Ac]
PrinceViktor: raises $075 to $125
Lorpugo: raises $250 to $375
PrinceViktor: calls $250
*** FLOP *** [Kh Jh 4c]
Lorpugo: checks
PrinceViktor: checks
*** TURN *** [Kh Jh 4c] [4s]
Lorpugo: bets $2
PrinceViktor: calls $2
*** RIVER *** [Kh Jh 4c 4s] [As]
Lorpugo: bets $546
PrinceViktor: folds
Uncalled bet ($546) returned to Lorpugo
Lorpugo collected $1092 from pot
Lorpugo: doesn't show hand
*** SUMMARY ***
Total pot $1150 | Rake $058
Board [Kh Jh 4c 4s As]
Seat 1: PrinceViktor (button) (small blind) folded on the River
Seat 2: Lorpugo (big blind) collected ($1092)


*********** # 33 **************
PokerStars Zoom Hand #235751901972: Hold'em No Limit ($025/$050) - 2022/04/26 15:45:57 ET
Table 'C Carinae' 2-max Seat #1 is the button
Seat 1: TheBluffPL ($50 in chips)
Seat 2: Lorpugo ($2578 in chips)
TheBluffPL: posts small blind $025
Lorpugo: posts big blind $050
*** HOLE CARDS ***
Dealt to Lorpugo [9h Ah]
TheBluffPL: raises $075 to $125
Lorpugo: raises $250 to $375
TheBluffPL: folds
Uncalled bet ($250) returned to Lorpugo
Lorpugo collected $250 from pot
Lorpugo: doesn't show hand
*** SUMMARY ***
Total pot $250 | Rake $0
Seat 1: TheBluffPL (button) (small blind) folded before Flop
Seat 2: Lorpugo (big blind) collected ($250)


*********** # 34 **************
PokerStars Zoom Hand #235751898153: Hold'em No Limit ($025/$050) - 2022/04/26 15:45:47 ET
Table 'C Carinae' 2-max Seat #1 is the button
Seat 1: Lorpugo ($2528 in chips)
Seat 2: drchilled ($5570 in chips)
Lorpugo: posts small blind $025
drchilled: posts big blind $050
*** HOLE CARDS ***
Dealt to Lorpugo [3d 6d]
Lorpugo: raises $050 to $1
drchilled: folds
Uncalled bet ($050) returned to Lorpugo
Lorpugo collected $1 from pot
Lorpugo: doesn't show hand
drchilled is disconnected
*** SUMMARY ***
Total pot $1 | Rake $0
Seat 1: Lorpugo (button) (small blind) collected ($1)
Seat 2: drchilled (big blind) folded before Flop


*********** # 35 **************
PokerStars Zoom Hand #235751891020: Hold'em No Limit ($025/$050) - 2022/04/26 15:45:28 ET
Table 'C Carinae' 2-max Seat #1 is the button
Seat 1: Lorpugo ($2438 in chips)
Seat 2: numbernine5 ($5598 in chips)
Lorpugo: posts small blind $025
numbernine5: posts big blind $050
*** HOLE CARDS ***
Dealt to Lorpugo [Qh 6s]
Lorpugo: raises $050 to $1
numbernine5: calls $050
*** FLOP *** [Js Jc 2c]
numbernine5: checks
Lorpugo: checks
*** TURN *** [Js Jc 2c] [7d]
numbernine5: checks
Lorpugo: bets $050
numbernine5: folds
Uncalled bet ($050) returned to Lorpugo
Lorpugo collected $190 from pot
Lorpugo: doesn't show hand
*** SUMMARY ***
Total pot $2 | Rake $010
Board [Js Jc 2c 7d]
Seat 1: Lorpugo (button) (small blind) collected ($190)
Seat 2: numbernine5 (big blind) folded on the Turn


*********** # 36 **************
PokerStars Zoom Hand #235751871945: Hold'em No Limit ($025/$050) - 2022/04/26 15:44:56 ET
Table 'C Carinae' 2-max Seat #1 is the button
Seat 1: karakoK10 ($4107 in chips)
Seat 2: Lorpugo ($2078 in chips)
karakoK10: posts small blind $025
Lorpugo: posts big blind $050
*** HOLE CARDS ***
Dealt to Lorpugo [Ac 8c]
Dealt to karakoK10 [Tc Kc]
karakoK10: raises $075 to $125
Lorpugo: raises $275 to $4
karakoK10: calls $275
*** FLOP *** [3c 4s Ad]
Lorpugo: checks
karakoK10: checks
*** TURN *** [3c 4s Ad] [2h]
Lorpugo: checks
karakoK10: checks
*** RIVER *** [3c 4s Ad 2h] [As]
Lorpugo: checks
karakoK10: checks
*** SHOW DOWN ***
Lorpugo: shows [Ac 8c] (three of a kind, Aces)
karakoK10: mucks hand
Lorpugo collected $760 from pot
*** SUMMARY ***
Total pot $8 | Rake $040
Board [3c 4s Ad 2h As]
Seat 1: karakoK10 (button) (small blind) mucked [Tc Kc]
Seat 2: Lorpugo (big blind) showed [Ac 8c] and won ($760) with three of a kind, Aces


*********** # 37 **************
PokerStars Zoom Hand #235751859429: Hold'em No Limit ($025/$050) - 2022/04/26 15:44:23 ET
Table 'C Carinae' 2-max Seat #1 is the button
Seat 1: Lorpugo ($1965 in chips)
Seat 2: PrinceViktor ($7381 in chips)
Lorpugo: posts small blind $025
PrinceViktor: posts big blind $050
*** HOLE CARDS ***
Dealt to Lorpugo [8d 9c]
Lorpugo: raises $075 to $125
PrinceViktor: calls $075
*** FLOP *** [2h Ks Qs]
PrinceViktor: checks
Lorpugo: bets $075
PrinceViktor: folds
Uncalled bet ($075) returned to Lorpugo
Lorpugo collected $238 from pot
Lorpugo: doesn't show hand
*** SUMMARY ***
Total pot $250 | Rake $012
Board [2h Ks Qs]
Seat 1: Lorpugo (button) (small blind) collected ($238)
Seat 2: PrinceViktor (big blind) folded on the Flop


*********** # 38 **************
PokerStars Zoom Hand #235751856833: Hold'em No Limit ($025/$050) - 2022/04/26 15:44:16 ET
Table 'C Carinae' 2-max Seat #1 is the button
Seat 1: ZenMisery ($50 in chips)
Seat 2: Lorpugo ($2015 in chips)
ZenMisery: posts small blind $025
Lorpugo: posts big blind $050
*** HOLE CARDS ***
Dealt to Lorpugo [9d 3c]
ZenMisery: raises $075 to $125
Lorpugo: folds
Uncalled bet ($075) returned to ZenMisery
ZenMisery collected $1 from pot
ZenMisery: doesn't show hand
*** SUMMARY ***
Total pot $1 | Rake $0
Seat 1: ZenMisery (button) (small blind) collected ($1)
Seat 2: Lorpugo (big blind) folded before Flop


*********** # 39 **************
PokerStars Zoom Hand #235751854863: Hold'em No Limit ($025/$050) - 2022/04/26 15:44:11 ET
Table 'C Carinae' 2-max Seat #1 is the button
Seat 1: Lorpugo ($2040 in chips)
Seat 2: scirocco994 ($11922 in chips)
Lorpugo: posts small blind $025
scirocco994: posts big blind $050
*** HOLE CARDS ***
Dealt to Lorpugo [3d 4h]
Lorpugo: folds
Uncalled bet ($025) returned to scirocco994
scirocco994 collected $050 from pot
scirocco994: doesn't show hand
*** SUMMARY ***
Total pot $050 | Rake $0
Seat 1: Lorpugo (button) (small blind) folded before Flop
Seat 2: scirocco994 (big blind) collected ($050)


*********** # 40 **************
PokerStars Zoom Hand #235751845749: Hold'em No Limit ($025/$050) - 2022/04/26 15:43:47 ET
Table 'C Carinae' 2-max Seat #1 is the button
Seat 1: scirocco994 ($12135 in chips)
Seat 2: Lorpugo ($1848 in chips)
scirocco994: posts small blind $025
Lorpugo: posts big blind $050
*** HOLE CARDS ***
Dealt to Lorpugo [3s Ah]
Dealt to scirocco994 [Js 8h]
scirocco994: raises $050 to $1
Lorpugo: calls $050
*** FLOP *** [3c 4s 6s]
Lorpugo: checks
scirocco994: checks
*** TURN *** [3c 4s 6s] [Td]
Lorpugo: bets $063
scirocco994: calls $063
*** RIVER *** [3c 4s 6s Td] [Kd]
Lorpugo: bets $050
scirocco994: calls $050
*** SHOW DOWN ***
Lorpugo: shows [3s Ah] (a pair of Threes)
scirocco994: mucks hand
Lorpugo collected $405 from pot
*** SUMMARY ***
Total pot $426 | Rake $021
Board [3c 4s 6s Td Kd]
Seat 1: scirocco994 (button) (small blind) mucked [Js 8h]
Seat 2: Lorpugo (big blind) showed [3s Ah] and won ($405) with a pair of Threes


*********** # 41 **************
PokerStars Zoom Hand #235751836475: Hold'em No Limit ($025/$050) - 2022/04/26 15:43:23 ET
Table 'C Carinae' 2-max Seat #1 is the button
Seat 1: Lorpugo ($1735 in chips)
Seat 2: E N L 22 ($50 in chips)
Lorpugo: posts small blind $025
E N L 22: posts big blind $050
*** HOLE CARDS ***
Dealt to Lorpugo [Qd 5d]
Lorpugo: raises $075 to $125
E N L 22: calls $075
*** FLOP *** [6h Ad Ts]
E N L 22: checks
Lorpugo: bets $079
E N L 22: folds
Uncalled bet ($079) returned to Lorpugo
Lorpugo collected $238 from pot
Lorpugo: doesn't show hand
E N L 22 is disconnected
*** SUMMARY ***
Total pot $250 | Rake $012
Board [6h Ad Ts]
Seat 1: Lorpugo (button) (small blind) collected ($238)
Seat 2: E N L 22 (big blind) folded on the Flop


*********** # 42 **************
PokerStars Zoom Hand #235751823283: Hold'em No Limit ($025/$050) - 2022/04/26 15:42:49 ET
Table 'C Carinae' 2-max Seat #1 is the button
Seat 1: Ares656 ($6351 in chips)
Seat 2: Lorpugo ($1910 in chips)
Ares656: posts small blind $025
Lorpugo: posts big blind $050
*** HOLE CARDS ***
Dealt to Lorpugo [7c 8d]
Ares656: raises $050 to $1
Lorpugo: calls $050
*** FLOP *** [Jc Qd Ts]
Lorpugo: checks
Ares656: checks
*** TURN *** [Jc Qd Ts] [Ad]
Lorpugo: bets $075
Ares656: calls $075
*** RIVER *** [Jc Qd Ts Ad] [3c]
Lorpugo: checks
Ares656: bets $498
Lorpugo: folds
Uncalled bet ($498) returned to Ares656
Ares656 collected $332 from pot
Ares656: doesn't show hand
*** SUMMARY ***
Total pot $350 | Rake $018
Board [Jc Qd Ts Ad 3c]
Seat 1: Ares656 (button) (small blind) collected ($332)
Seat 2: Lorpugo (big blind) folded on the River


*********** # 43 **************
PokerStars Zoom Hand #235751816050: Hold'em No Limit ($025/$050) - 2022/04/26 15:42:29 ET
Table 'C Carinae' 2-max Seat #1 is the button
Seat 1: Lorpugo ($1797 in chips)
Seat 2: BRoGeRZ ($7150 in chips)
Lorpugo: posts small blind $025
BRoGeRZ: posts big blind $050
*** HOLE CARDS ***
Dealt to Lorpugo [Ah 4c]
Lorpugo: raises $075 to $125
BRoGeRZ: calls $075
*** FLOP *** [Ts Jc Td]
BRoGeRZ: checks
Lorpugo: checks
*** TURN *** [Ts Jc Td] [6c]
BRoGeRZ: checks
Lorpugo: bets $079
BRoGeRZ: folds
Uncalled bet ($079) returned to Lorpugo
Lorpugo collected $238 from pot
Lorpugo: doesn't show hand
*** SUMMARY ***
Total pot $250 | Rake $012
Board [Ts Jc Td 6c]
Seat 1: Lorpugo (button) (small blind) collected ($238)
Seat 2: BRoGeRZ (big blind) folded on the Turn


*********** # 44 **************
PokerStars Zoom Hand #235751808488: Hold'em No Limit ($025/$050) - 2022/04/26 15:42:09 ET
Table 'C Carinae' 2-max Seat #1 is the button
Seat 1: TheBluffPL ($5809 in chips)
Seat 2: Lorpugo ($1672 in chips)
TheBluffPL: posts small blind $025
Lorpugo: posts big blind $050
*** HOLE CARDS ***
Dealt to Lorpugo [Ad 5s]
TheBluffPL: raises $075 to $125
Lorpugo: raises $275 to $4
TheBluffPL: folds
Uncalled bet ($275) returned to Lorpugo
Lorpugo collected $250 from pot
Lorpugo: doesn't show hand
*** SUMMARY ***
Total pot $250 | Rake $0
Seat 1: TheBluffPL (button) (small blind) folded before Flop
Seat 2: Lorpugo (big blind) collected ($250)


*********** # 45 **************
PokerStars Zoom Hand #235751799136: Hold'em No Limit ($025/$050) - 2022/04/26 15:41:45 ET
Table 'C Carinae' 2-max Seat #1 is the button
Seat 1: Lorpugo ($1859 in chips)
Seat 2: Ares656 ($6183 in chips)
Lorpugo: posts small blind $025
Ares656: posts big blind $050
*** HOLE CARDS ***
Dealt to Lorpugo [Qs 6h]
Lorpugo: raises $065 to $115
Ares656: calls $065
*** FLOP *** [7c Jd 6s]
Ares656: checks
Lorpugo: bets $072
Ares656: raises $278 to $350
Lorpugo: folds
Uncalled bet ($278) returned to Ares656
Ares656 collected $355 from pot
Ares656: doesn't show hand
*** SUMMARY ***
Total pot $374 | Rake $019
Board [7c Jd 6s]
Seat 1: Lorpugo (button) (small blind) folded on the Flop
Seat 2: Ares656 (big blind) collected ($355)


*********** # 46 **************
PokerStars Zoom Hand #235751792238: Hold'em No Limit ($025/$050) - 2022/04/26 15:41:27 ET
Table 'C Carinae' 2-max Seat #1 is the button
Seat 1: Ares656 ($6298 in chips)
Seat 2: Lorpugo ($1744 in chips)
Ares656: posts small blind $025
Lorpugo: posts big blind $050
*** HOLE CARDS ***
Dealt to Lorpugo [Qs Ac]
Ares656: raises $065 to $115
Lorpugo: raises $260 to $375
Ares656: folds
Uncalled bet ($260) returned to Lorpugo
Lorpugo collected $230 from pot
Lorpugo: doesn't show hand
*** SUMMARY ***
Total pot $230 | Rake $0
Seat 1: Ares656 (button) (small blind) folded before Flop
Seat 2: Lorpugo (big blind) collected ($230)


*********** # 47 **************
PokerStars Zoom Hand #235751788826: Hold'em No Limit ($025/$050) - 2022/04/26 15:41:18 ET
Table 'C Carinae' 2-max Seat #1 is the button
Seat 1: Lorpugo ($1694 in chips)
Seat 2: scirocco994 ($13065 in chips)
Lorpugo: posts small blind $025
scirocco994: posts big blind $050
*** HOLE CARDS ***
Dealt to Lorpugo [7c 5c]
Lorpugo: raises $075 to $125
scirocco994: folds
Uncalled bet ($075) returned to Lorpugo
Lorpugo collected $1 from pot
Lorpugo: doesn't show hand
*** SUMMARY ***
Total pot $1 | Rake $0
Seat 1: Lorpugo (button) (small blind) collected ($1)
Seat 2: scirocco994 (big blind) folded before Flop


*********** # 48 **************
PokerStars Zoom Hand #235751786239: Hold'em No Limit ($025/$050) - 2022/04/26 15:41:11 ET
Table 'C Carinae' 2-max Seat #1 is the button
Seat 1: xRhythm ($5065 in chips)
Seat 2: Lorpugo ($1669 in chips)
xRhythm: posts small blind $025
Lorpugo: posts big blind $050
*** HOLE CARDS ***
Dealt to Lorpugo [As 7d]
xRhythm: folds
Uncalled bet ($025) returned to Lorpugo
Lorpugo collected $050 from pot
Lorpugo: doesn't show hand
*** SUMMARY ***
Total pot $050 | Rake $0
Seat 1: xRhythm (button) (small blind) folded before Flop
Seat 2: Lorpugo (big blind) collected ($050)


*********** # 49 **************
PokerStars Zoom Hand #235751781586: Hold'em No Limit ($025/$050) - 2022/04/26 15:40:59 ET
Table 'C Carinae' 2-max Seat #1 is the button
Seat 1: Lorpugo ($1619 in chips)
Seat 2: xRhythm ($5115 in chips)
Lorpugo: posts small blind $025
xRhythm: posts big blind $050
*** HOLE CARDS ***
Dealt to Lorpugo [Ac 8h]
Lorpugo: raises $075 to $125
xRhythm: folds
Uncalled bet ($075) returned to Lorpugo
Lorpugo collected $1 from pot
Lorpugo: doesn't show hand
*** SUMMARY ***
Total pot $1 | Rake $0
Seat 1: Lorpugo (button) (small blind) collected ($1)
Seat 2: xRhythm (big blind) folded before Flop


*********** # 50 **************
PokerStars Zoom Hand #235751776779: Hold'em No Limit ($025/$050) - 2022/04/26 15:40:47 ET
Table 'C Carinae' 2-max Seat #1 is the button
Seat 1: PrinceViktor ($5050 in chips)
Seat 2: Lorpugo ($1669 in chips)
PrinceViktor: posts small blind $025
Lorpugo: posts big blind $050
*** HOLE CARDS ***
Dealt to Lorpugo [Kh 2c]
PrinceViktor: raises $075 to $125
Lorpugo: folds
Uncalled bet ($075) returned to PrinceViktor
PrinceViktor collected $1 from pot
PrinceViktor: doesn't show hand
*** SUMMARY ***
Total pot $1 | Rake $0
Seat 1: PrinceViktor (button) (small blind) collected ($1)
Seat 2: Lorpugo (big blind) folded before Flop


*********** # 51 **************
PokerStars Zoom Hand #235751774916: Hold'em No Limit ($025/$050) - 2022/04/26 15:40:42 ET
Table 'C Carinae' 2-max Seat #1 is the button
Seat 1: Lorpugo ($1694 in chips)
Seat 2: I kill U 84 ($6602 in chips)
Lorpugo: posts small blind $025
I kill U 84: posts big blind $050
*** HOLE CARDS ***
Dealt to Lorpugo [3h 4s]
Lorpugo: folds
Uncalled bet ($025) returned to I kill U 84
I kill U 84 collected $050 from pot
I kill U 84: doesn't show hand
*** SUMMARY ***
Total pot $050 | Rake $0
Seat 1: Lorpugo (button) (small blind) folded before Flop
Seat 2: I kill U 84 (big blind) collected ($050)


*********** # 52 **************
PokerStars Zoom Hand #235751772232: Hold'em No Limit ($025/$050) - 2022/04/26 15:40:35 ET
Table 'C Carinae' 2-max Seat #1 is the button
Seat 1: BRoGeRZ ($1940 in chips)
Seat 2: Lorpugo ($1669 in chips)
BRoGeRZ: posts small blind $025
Lorpugo: posts big blind $050
*** HOLE CARDS ***
Dealt to Lorpugo [4d Ac]
BRoGeRZ: folds
Uncalled bet ($025) returned to Lorpugo
Lorpugo collected $050 from pot
Lorpugo: doesn't show hand
*** SUMMARY ***
Total pot $050 | Rake $0
Seat 1: BRoGeRZ (button) (small blind) folded before Flop
Seat 2: Lorpugo (big blind) collected ($050)


*********** # 53 **************
PokerStars Zoom Hand #235751762828: Hold'em No Limit ($025/$050) - 2022/04/26 15:40:10 ET
Table 'C Carinae' 2-max Seat #1 is the button
Seat 1: Lorpugo ($1794 in chips)
Seat 2: EkimM1978 ($4251 in chips)
Lorpugo: posts small blind $025
EkimM1978: posts big blind $050
*** HOLE CARDS ***
Dealt to Lorpugo [Th 7s]
Dealt to EkimM1978 [Tc 9s]
Lorpugo: raises $075 to $125
EkimM1978: calls $075
*** FLOP *** [6h Jd 5h]
EkimM1978: checks
Lorpugo: checks
*** TURN *** [6h Jd 5h] [2s]
EkimM1978: checks
Lorpugo: checks
*** RIVER *** [6h Jd 5h 2s] [Js]
EkimM1978: checks
Lorpugo: checks
*** SHOW DOWN ***
EkimM1978: shows [Tc 9s] (a pair of Jacks)
Lorpugo: mucks hand
EkimM1978 collected $235 from pot
*** SUMMARY ***
Total pot $250 | Rake $015
Board [6h Jd 5h 2s Js]
Seat 1: Lorpugo (button) (small blind) mucked [Th 7s]
Seat 2: EkimM1978 (big blind) showed [Tc 9s] and won ($235) with a pair of Jacks


*********** # 54 **************
PokerStars Zoom Hand #235751760091: Hold'em No Limit ($025/$050) - 2022/04/26 15:40:03 ET
Table 'C Carinae' 2-max Seat #1 is the button
Seat 1: I kill U 84 ($6527 in chips)
Seat 2: Lorpugo ($1769 in chips)
I kill U 84: posts small blind $025
Lorpugo: posts big blind $050
*** HOLE CARDS ***
Dealt to Lorpugo [9h 3s]
I kill U 84: folds
Uncalled bet ($025) returned to Lorpugo
Lorpugo collected $050 from pot
Lorpugo: doesn't show hand
*** SUMMARY ***
Total pot $050 | Rake $0
Seat 1: I kill U 84 (button) (small blind) folded before Flop
Seat 2: Lorpugo (big blind) collected ($050)


*********** # 55 **************
PokerStars Zoom Hand #235751745347: Hold'em No Limit ($025/$050) - 2022/04/26 15:39:24 ET
Table 'C Carinae' 2-max Seat #1 is the button
Seat 1: Lorpugo ($2086 in chips)
Seat 2: I kill U 84 ($6250 in chips)
Lorpugo: posts small blind $025
I kill U 84: posts big blind $050
*** HOLE CARDS ***
Dealt to Lorpugo [9d 2d]
Dealt to I kill U [2s Ad]
Lorpugo: raises $050 to $1
I kill U 84: calls $050
*** FLOP *** [6d 7h 6c]
I kill U 84: checks
Lorpugo: bets $095
I kill U 84: calls $095
*** TURN *** [6d 7h 6c] [2c]
I kill U 84: checks
Lorpugo: bets $122
I kill U 84: calls $122
*** RIVER *** [6d 7h 6c 2c] [8s]
I kill U 84: checks
Lorpugo: checks
*** SHOW DOWN ***
I kill U 84: shows [2s Ad] (two pair, Sixes and Deuces)
Lorpugo: mucks hand
I kill U 84 collected $594 from pot
*** SUMMARY ***
Total pot $634 | Rake $040
Board [6d 7h 6c 2c 8s]
Seat 1: Lorpugo (button) (small blind) mucked [9d 2d]
Seat 2: I kill U 84 (big blind) showed [2s Ad] and won ($594) with two pair, Sixes and Deuces


*********** # 56 **************
PokerStars Zoom Hand #235751737855: Hold'em No Limit ($025/$050) - 2022/04/26 15:39:09 ET
Table 'C Carinae' 2-max Seat #1 is the button
Seat 1: PrinceViktor ($7683 in chips)
Seat 2: Lorpugo ($2136 in chips)
PrinceViktor: posts small blind $025
Lorpugo: posts big blind $050
*** HOLE CARDS ***
Dealt to Lorpugo [4c 5h]
PrinceViktor: raises $075 to $125
Lorpugo: folds
Uncalled bet ($075) returned to PrinceViktor
PrinceViktor collected $1 from pot
PrinceViktor: doesn't show hand
*** SUMMARY ***
Total pot $1 | Rake $0
Seat 1: PrinceViktor (button) (small blind) collected ($1)
Seat 2: Lorpugo (big blind) folded before Flop


*********** # 57 **************
PokerStars Zoom Hand #235751734146: Hold'em No Limit ($025/$050) - 2022/04/26 15:38:59 ET
Table 'C Carinae' 2-max Seat #1 is the button
Seat 1: Lorpugo ($2161 in chips)
Seat 2: numbernine5 ($5929 in chips)
Lorpugo: posts small blind $025
numbernine5: posts big blind $050
*** HOLE CARDS ***
Dealt to Lorpugo [8d 2s]
Lorpugo: folds
Uncalled bet ($025) returned to numbernine5
numbernine5 collected $050 from pot
numbernine5: doesn't show hand
*** SUMMARY ***
Total pot $050 | Rake $0
Seat 1: Lorpugo (button) (small blind) folded before Flop
Seat 2: numbernine5 (big blind) collected ($050)


*********** # 58 **************
PokerStars Zoom Hand #235751726833: Hold'em No Limit ($025/$050) - 2022/04/26 15:38:40 ET
Table 'C Carinae' 2-max Seat #1 is the button
Seat 1: PrinceViktor ($5592 in chips)
Seat 2: Lorpugo ($2036 in chips)
PrinceViktor: posts small blind $025
Lorpugo: posts big blind $050
*** HOLE CARDS ***
Dealt to Lorpugo [Ts Ah]
PrinceViktor: raises $075 to $125
Lorpugo: raises $275 to $4
PrinceViktor: folds
Uncalled bet ($275) returned to Lorpugo
Lorpugo collected $250 from pot
Lorpugo: doesn't show hand
*** SUMMARY ***
Total pot $250 | Rake $0
Seat 1: PrinceViktor (button) (small blind) folded before Flop
Seat 2: Lorpugo (big blind) collected ($250)


*********** # 59 **************
PokerStars Zoom Hand #235751718889: Hold'em No Limit ($025/$050) - 2022/04/26 15:38:19 ET
Table 'C Carinae' 2-max Seat #1 is the button
Seat 1: Lorpugo ($2161 in chips)
Seat 2: iulian3000 ($7343 in chips)
Lorpugo: posts small blind $025
iulian3000: posts big blind $050
*** HOLE CARDS ***
Dealt to Lorpugo [7c 8c]
Lorpugo: raises $075 to $125
iulian3000: calls $075
*** FLOP *** [Kc Qs 4s]
iulian3000: bets $1
Lorpugo: folds
Uncalled bet ($1) returned to iulian3000
iulian3000 collected $238 from pot
iulian3000: doesn't show hand
*** SUMMARY ***
Total pot $250 | Rake $012
Board [Kc Qs 4s]
Seat 1: Lorpugo (button) (small blind) folded on the Flop
Seat 2: iulian3000 (big blind) collected ($238)


*********** # 60 **************
PokerStars Zoom Hand #235751709299: Hold'em No Limit ($025/$050) - 2022/04/26 15:37:54 ET
Table 'C Carinae' 2-max Seat #1 is the button
Seat 1: karakoK10 ($4087 in chips)
Seat 2: Lorpugo ($2261 in chips)
karakoK10: posts small blind $025
Lorpugo: posts big blind $050
*** HOLE CARDS ***
Dealt to Lorpugo [Ks 3d]
karakoK10: calls $025
Lorpugo: checks
*** FLOP *** [Qc Qh 4d]
Lorpugo: checks
karakoK10: checks
*** TURN *** [Qc Qh 4d] [Jc]
Lorpugo: bets $050
karakoK10: calls $050
*** RIVER *** [Qc Qh 4d Jc] [8c]
Lorpugo: checks
karakoK10: bets $050
Lorpugo: folds
Uncalled bet ($050) returned to karakoK10
karakoK10 collected $190 from pot
karakoK10: doesn't show hand
*** SUMMARY ***
Total pot $2 | Rake $010
Board [Qc Qh 4d Jc 8c]
Seat 1: karakoK10 (button) (small blind) collected ($190)
Seat 2: Lorpugo (big blind) folded on the River


*********** # 61 **************
PokerStars Zoom Hand #235751692579: Hold'em No Limit ($025/$050) - 2022/04/26 15:37:10 ET
Table 'C Carinae' 2-max Seat #1 is the button
Seat 1: Lorpugo ($2271 in chips)
Seat 2: PrinceViktor ($5475 in chips)
Lorpugo: posts small blind $025
PrinceViktor: posts big blind $050
*** HOLE CARDS ***
Dealt to Lorpugo [3h Ah]
Lorpugo: raises $075 to $125
PrinceViktor: calls $075
*** FLOP *** [2d Ts 5s]
PrinceViktor: checks
Lorpugo: bets $079
PrinceViktor: calls $079
*** TURN *** [2d Ts 5s] [6h]
PrinceViktor: checks
Lorpugo: checks
*** RIVER *** [2d Ts 5s 6h] [9c]
PrinceViktor: checks
Lorpugo: checks
*** SHOW DOWN ***
PrinceViktor: shows [3d As] (high card Ace)
Lorpugo: shows [3h Ah] (high card Ace)
PrinceViktor collected $192 from pot
Lorpugo collected $194 from pot
*** SUMMARY ***
Total pot $408 | Rake $022
Board [2d Ts 5s 6h 9c]
Seat 1: Lorpugo (button) (small blind) showed [3h Ah] and won ($194) with high card Ace
Seat 2: PrinceViktor (big blind) showed [3d As] and won ($192) with high card Ace


*********** # 62 **************
PokerStars Zoom Hand #235751680688: Hold'em No Limit ($025/$050) - 2022/04/26 15:36:39 ET
Table 'C Carinae' 2-max Seat #1 is the button
Seat 1: PrinceViktor ($5075 in chips)
Seat 2: Lorpugo ($2671 in chips)
PrinceViktor: posts small blind $025
Lorpugo: posts big blind $050
*** HOLE CARDS ***
Dealt to Lorpugo [5s Ad]
PrinceViktor: raises $075 to $125
Lorpugo: raises $275 to $4
PrinceViktor: raises $4675 to $5075 and is all-in
Lorpugo: folds
Uncalled bet ($4675) returned to PrinceViktor
PrinceViktor collected $8 from pot
PrinceViktor: doesn't show hand
*** SUMMARY ***
Total pot $8 | Rake $0
Seat 1: PrinceViktor (button) (small blind) collected ($8)
Seat 2: Lorpugo (big blind) folded before Flop


*********** # 63 **************
PokerStars Zoom Hand #235751676559: Hold'em No Limit ($025/$050) - 2022/04/26 15:36:28 ET
Table 'C Carinae' 2-max Seat #1 is the button
Seat 1: Lorpugo ($2621 in chips)
Seat 2: xRhythm ($5115 in chips)
Lorpugo: posts small blind $025
xRhythm: posts big blind $050
*** HOLE CARDS ***
Dealt to Lorpugo [Ks 7d]
Lorpugo: raises $075 to $125
xRhythm: folds
Uncalled bet ($075) returned to Lorpugo
Lorpugo collected $1 from pot
Lorpugo: doesn't show hand
*** SUMMARY ***
Total pot $1 | Rake $0
Seat 1: Lorpugo (button) (small blind) collected ($1)
Seat 2: xRhythm (big blind) folded before Flop


*********** # 64 **************
PokerStars Zoom Hand #235751664020: Hold'em No Limit ($025/$050) - 2022/04/26 15:35:55 ET
Table 'C Carinae' 2-max Seat #1 is the button
Seat 1: Lorpugo ($2508 in chips)
Seat 2: guillermo324 ($4659 in chips)
Lorpugo: posts small blind $025
guillermo324: posts big blind $050
*** HOLE CARDS ***
Dealt to Lorpugo [8d 8c]
Lorpugo: raises $075 to $125
guillermo324: calls $075
*** FLOP *** [Jd Td 2h]
guillermo324: checks
Lorpugo: checks
*** TURN *** [Jd Td 2h] [Th]
guillermo324: checks
Lorpugo: bets $145
guillermo324: folds
Uncalled bet ($145) returned to Lorpugo
Lorpugo collected $238 from pot
Lorpugo: doesn't show hand
guillermo324 is disconnected
*** SUMMARY ***
Total pot $250 | Rake $012
Board [Jd Td 2h Th]
Seat 1: Lorpugo (button) (small blind) collected ($238)
Seat 2: guillermo324 (big blind) folded on the Turn


*********** # 65 **************
PokerStars Zoom Hand #235751651729: Hold'em No Limit ($025/$050) - 2022/04/26 15:35:23 ET
Table 'C Carinae' 2-max Seat #1 is the button
Seat 1: PrinceViktor ($8104 in chips)
Seat 2: Lorpugo ($2633 in chips)
PrinceViktor: posts small blind $025
Lorpugo: posts big blind $050
*** HOLE CARDS ***
Dealt to Lorpugo [7h 8s]
PrinceViktor: raises $075 to $125
Lorpugo: calls $075
*** FLOP *** [8d Ks Qd]
Lorpugo: checks
PrinceViktor: bets $079
Lorpugo: folds
Uncalled bet ($079) returned to PrinceViktor
PrinceViktor collected $235 from pot
PrinceViktor: doesn't show hand
*** SUMMARY ***
Total pot $250 | Rake $015
Board [8d Ks Qd]
Seat 1: PrinceViktor (button) (small blind) collected ($235)
Seat 2: Lorpugo (big blind) folded on the Flop


*********** # 66 **************
PokerStars Zoom Hand #235751632020: Hold'em No Limit ($025/$050) - 2022/04/26 15:34:30 ET
Table 'C Carinae' 2-max Seat #1 is the button
Seat 1: iulian3000 ($3556 in chips)
Seat 2: Lorpugo ($2655 in chips)
iulian3000: posts small blind $025
Lorpugo: posts big blind $050
*** HOLE CARDS ***
Dealt to Lorpugo [4s 6c]
iulian3000: calls $025
Lorpugo: checks
*** FLOP *** [5d 5h 4d]
Lorpugo: checks
iulian3000: bets $150
Lorpugo: calls $150
*** TURN *** [5d 5h 4d] [Qs]
Lorpugo: checks
iulian3000: bets $250
Lorpugo: calls $250
*** RIVER *** [5d 5h 4d Qs] [3d]
Lorpugo: checks
iulian3000: checks
*** SHOW DOWN ***
Lorpugo: shows [4s 6c] (two pair, Fives and Fours)
iulian3000: shows [4h 3h] (two pair, Fives and Fours)
Lorpugo collected $428 from pot
iulian3000 collected $427 from pot
*** SUMMARY ***
Total pot $9 | Rake $045
Board [5d 5h 4d Qs 3d]
Seat 1: iulian3000 (button) (small blind) showed [4h 3h] and won ($427) with two pair, Fives and Fours
Seat 2: Lorpugo (big blind) showed [4s 6c] and won ($428) with two pair, Fives and Fours


*********** # 67 **************
PokerStars Zoom Hand #235751605067: Hold'em No Limit ($025/$050) - 2022/04/26 15:33:20 ET
Table 'C Carinae' 2-max Seat #1 is the button
Seat 1: Lorpugo ($3334 in chips)
Seat 2: TheBluffPL ($10881 in chips)
Lorpugo: posts small blind $025
TheBluffPL: posts big blind $050
*** HOLE CARDS ***
Dealt to Lorpugo [7s Ac]
Lorpugo: raises $075 to $125
TheBluffPL: calls $075
*** FLOP *** [Jc 5s 9c]
TheBluffPL: checks
Lorpugo: checks
*** TURN *** [Jc 5s 9c] [7c]
TheBluffPL: bets $155
Lorpugo: calls $155
*** RIVER *** [Jc 5s 9c 7c] [7h]
TheBluffPL: bets $399
Lorpugo: calls $399
*** SHOW DOWN ***
TheBluffPL: shows [8c Qc] (a flush, Queen high)
Lorpugo: mucks hand
TheBluffPL collected $1290 from pot
*** SUMMARY ***
Total pot $1358 | Rake $068
Board [Jc 5s 9c 7c 7h]
Seat 1: Lorpugo (button) (small blind) mucked [7s Ac]
Seat 2: TheBluffPL (big blind) showed [8c Qc] and won ($1290) with a flush, Queen high


*********** # 68 **************
PokerStars Zoom Hand #235751601611: Hold'em No Limit ($025/$050) - 2022/04/26 15:33:11 ET
Table 'C Carinae' 2-max Seat #1 is the button
Seat 1: Lorpugo ($3359 in chips)
Seat 2: numbernine5 ($5213 in chips)
Lorpugo: posts small blind $025
numbernine5: posts big blind $050
*** HOLE CARDS ***
Dealt to Lorpugo [3h 2s]
Lorpugo: folds
Uncalled bet ($025) returned to numbernine5
numbernine5 collected $050 from pot
numbernine5: doesn't show hand
*** SUMMARY ***
Total pot $050 | Rake $0
Seat 1: Lorpugo (button) (small blind) folded before Flop
Seat 2: numbernine5 (big blind) collected ($050)


*********** # 69 **************
PokerStars Zoom Hand #235751595304: Hold'em No Limit ($025/$050) - 2022/04/26 15:32:55 ET
Table 'C Carinae' 2-max Seat #1 is the button
Seat 1: PrinceViktor ($6951 in chips)
Seat 2: Lorpugo ($3409 in chips)
PrinceViktor: posts small blind $025
Lorpugo: posts big blind $050
*** HOLE CARDS ***
Dealt to Lorpugo [2c 3h]
PrinceViktor: raises $075 to $125
Lorpugo: folds
Uncalled bet ($075) returned to PrinceViktor
PrinceViktor collected $1 from pot
PrinceViktor: doesn't show hand
*** SUMMARY ***
Total pot $1 | Rake $0
Seat 1: PrinceViktor (button) (small blind) collected ($1)
Seat 2: Lorpugo (big blind) folded before Flop


*********** # 70 **************
PokerStars Zoom Hand #235751578300: Hold'em No Limit ($025/$050) - 2022/04/26 15:32:11 ET
Table 'C Carinae' 2-max Seat #1 is the button
Seat 1: Lorpugo ($3614 in chips)
Seat 2: PrinceViktor ($6771 in chips)
Lorpugo: posts small blind $025
PrinceViktor: posts big blind $050
*** HOLE CARDS ***
Dealt to Lorpugo [2s 4s]
Lorpugo: raises $050 to $1
PrinceViktor: calls $050
*** FLOP *** [Ts 3d Kc]
PrinceViktor: checks
Lorpugo: checks
*** TURN *** [Ts 3d Kc] [5d]
PrinceViktor: checks
Lorpugo: bets $105
PrinceViktor: calls $105
*** RIVER *** [Ts 3d Kc 5d] [8c]
PrinceViktor: checks
Lorpugo: checks
*** SHOW DOWN ***
PrinceViktor: shows [Tc 6s] (a pair of Tens)
Lorpugo: mucks hand
PrinceViktor collected $385 from pot
*** SUMMARY ***
Total pot $410 | Rake $025
Board [Ts 3d Kc 5d 8c]
Seat 1: Lorpugo (button) (small blind) mucked [2s 4s]
Seat 2: PrinceViktor (big blind) showed [Tc 6s] and won ($385) with a pair of Tens


*********** # 71 **************
PokerStars Zoom Hand #235751567144: Hold'em No Limit ($025/$050) - 2022/04/26 15:31:42 ET
Table 'C Carinae' 2-max Seat #1 is the button
Seat 1: karakoK10 ($4230 in chips)
Seat 2: Lorpugo ($3764 in chips)
karakoK10: posts small blind $025
Lorpugo: posts big blind $050
*** HOLE CARDS ***
Dealt to Lorpugo [6h Kc]
karakoK10: raises $050 to $1
Lorpugo: calls $050
*** FLOP *** [4c Jd 7h]
Lorpugo: bets $050
karakoK10: raises $247 to $297
Lorpugo: folds
Uncalled bet ($247) returned to karakoK10
karakoK10 collected $285 from pot
karakoK10: doesn't show hand
*** SUMMARY ***
Total pot $3 | Rake $015
Board [4c Jd 7h]
Seat 1: karakoK10 (button) (small blind) collected ($285)
Seat 2: Lorpugo (big blind) folded on the Flop


*********** # 72 **************
PokerStars Zoom Hand #235751540614: Hold'em No Limit ($025/$050) - 2022/04/26 15:30:34 ET
Table 'C Carinae' 2-max Seat #1 is the button
Seat 1: E N L 22 ($1389 in chips)
Seat 2: Lorpugo ($2450 in chips)
E N L 22: posts small blind $025
Lorpugo: posts big blind $050
*** HOLE CARDS ***
Dealt to Lorpugo [Qs 4d]
E N L 22: calls $025
Lorpugo: checks
*** FLOP *** [9d Qc 3c]
Lorpugo: checks
E N L 22: bets $095
Lorpugo: calls $095
*** TURN *** [9d Qc 3c] [Ts]
Lorpugo: checks
E N L 22: bets $276
Lorpugo: calls $276
*** RIVER *** [9d Qc 3c Ts] [5c]
Lorpugo: checks
E N L 22: bets $968 and is all-in
Lorpugo: calls $968
*** SHOW DOWN ***
E N L 22: shows [3d Kc] (a pair of Threes)
Lorpugo: shows [Qs 4d] (a pair of Queens)
Lorpugo collected $2703 from pot
*** SUMMARY ***
Total pot $2778 | Rake $075
Board [9d Qc 3c Ts 5c]
Seat 1: E N L 22 (button) (small blind) showed [3d Kc] and lost with a pair of Threes
Seat 2: Lorpugo (big blind) showed [Qs 4d] and won ($2703) with a pair of Queens


*********** # 73 **************
PokerStars Zoom Hand #235751531068: Hold'em No Limit ($025/$050) - 2022/04/26 15:30:09 ET
Table 'C Carinae' 2-max Seat #1 is the button
Seat 1: Lorpugo ($2337 in chips)
Seat 2: Ares656 ($50 in chips)
Lorpugo: posts small blind $025
Ares656: posts big blind $050
*** HOLE CARDS ***
Dealt to Lorpugo [Js 7d]
Lorpugo: raises $075 to $125
Ares656: calls $075
*** FLOP *** [5c Ad Jd]
Ares656: checks
Lorpugo: bets $079
Ares656: folds
Uncalled bet ($079) returned to Lorpugo
Lorpugo collected $238 from pot
Lorpugo: doesn't show hand
*** SUMMARY ***
Total pot $250 | Rake $012
Board [5c Ad Jd]
Seat 1: Lorpugo (button) (small blind) collected ($238)
Seat 2: Ares656 (big blind) folded on the Flop


*********** # 74 **************
PokerStars Zoom Hand #235751521208: Hold'em No Limit ($025/$050) - 2022/04/26 15:29:43 ET
Table 'C Carinae' 2-max Seat #1 is the button
Seat 1: MeryjanePL ($5298 in chips)
Seat 2: Lorpugo ($1932 in chips)
MeryjanePL: posts small blind $025
Lorpugo: posts big blind $050
*** HOLE CARDS ***
Dealt to Lorpugo [4d 7d]
MeryjanePL: raises $1 to $150
Lorpugo: raises $3 to $450
MeryjanePL: calls $3
*** FLOP *** [Kh 8d 6s]
Lorpugo: bets $1482 and is all-in
MeryjanePL: folds
Uncalled bet ($1482) returned to Lorpugo
Lorpugo collected $855 from pot
Lorpugo: doesn't show hand
*** SUMMARY ***
Total pot $9 | Rake $045
Board [Kh 8d 6s]
Seat 1: MeryjanePL (button) (small blind) folded on the Flop
Seat 2: Lorpugo (big blind) collected ($855)


*********** # 75 **************
PokerStars Zoom Hand #235751516250: Hold'em No Limit ($025/$050) - 2022/04/26 15:29:30 ET
Table 'C Carinae' 2-max Seat #1 is the button
Seat 1: Lorpugo ($1882 in chips)
Seat 2: luirian_1989 ($2606 in chips)
Lorpugo: posts small blind $025
luirian_1989: posts big blind $050
*** HOLE CARDS ***
Dealt to Lorpugo [6c Qh]
Lorpugo: raises $075 to $125
luirian_1989: folds
Uncalled bet ($075) returned to Lorpugo
Lorpugo collected $1 from pot
Lorpugo: doesn't show hand
*** SUMMARY ***
Total pot $1 | Rake $0
Seat 1: Lorpugo (button) (small blind) collected ($1)
Seat 2: luirian_1989 (big blind) folded before Flop


*********** # 76 **************
PokerStars Zoom Hand #235751513878: Hold'em No Limit ($025/$050) - 2022/04/26 15:29:23 ET
Table 'C Carinae' 2-max Seat #1 is the button
Seat 1: ExtasyGanja ($6537 in chips)
Seat 2: Lorpugo ($1857 in chips)
ExtasyGanja: posts small blind $025
Lorpugo: posts big blind $050
*** HOLE CARDS ***
Dealt to Lorpugo [8s Ac]
ExtasyGanja: folds
Uncalled bet ($025) returned to Lorpugo
Lorpugo collected $050 from pot
Lorpugo: doesn't show hand
*** SUMMARY ***
Total pot $050 | Rake $0
Seat 1: ExtasyGanja (button) (small blind) folded before Flop
Seat 2: Lorpugo (big blind) collected ($050)


*********** # 77 **************
PokerStars Zoom Hand #235751505782: Hold'em No Limit ($025/$050) - 2022/04/26 15:29:02 ET
Table 'C Carinae' 2-max Seat #1 is the button
Seat 1: Lorpugo ($1807 in chips)
Seat 2: TheBluffPL ($10696 in chips)
Lorpugo: posts small blind $025
TheBluffPL: posts big blind $050
*** HOLE CARDS ***
Dealt to Lorpugo [9d Th]
Lorpugo: raises $075 to $125
TheBluffPL: folds
Uncalled bet ($075) returned to Lorpugo
Lorpugo collected $1 from pot
Lorpugo: doesn't show hand
*** SUMMARY ***
Total pot $1 | Rake $0
Seat 1: Lorpugo (button) (small blind) collected ($1)
Seat 2: TheBluffPL (big blind) folded before Flop


*********** # 78 **************
PokerStars Zoom Hand #235751496944: Hold'em No Limit ($025/$050) - 2022/04/26 15:28:39 ET
Table 'C Carinae' 2-max Seat #1 is the button
Seat 1: TheBluffPL ($10821 in chips)
Seat 2: Lorpugo ($1682 in chips)
TheBluffPL: posts small blind $025
Lorpugo: posts big blind $050
*** HOLE CARDS ***
Dealt to Lorpugo [9c 7c]
TheBluffPL: raises $075 to $125
Lorpugo: raises $275 to $4
TheBluffPL: folds
Uncalled bet ($275) returned to Lorpugo
Lorpugo collected $250 from pot
Lorpugo: doesn't show hand
*** SUMMARY ***
Total pot $250 | Rake $0
Seat 1: TheBluffPL (button) (small blind) folded before Flop
Seat 2: Lorpugo (big blind) collected ($250)


*********** # 79 **************
PokerStars Zoom Hand #235751492702: Hold'em No Limit ($025/$050) - 2022/04/26 15:28:28 ET
Table 'C Carinae' 2-max Seat #1 is the button
Seat 1: Lorpugo ($1632 in chips)
Seat 2: PrinceViktor ($7195 in chips)
Lorpugo: posts small blind $025
PrinceViktor: posts big blind $050
*** HOLE CARDS ***
Dealt to Lorpugo [5c 7c]
Lorpugo: raises $075 to $125
PrinceViktor: folds
Uncalled bet ($075) returned to Lorpugo
Lorpugo collected $1 from pot
Lorpugo: doesn't show hand
*** SUMMARY ***
Total pot $1 | Rake $0
Seat 1: Lorpugo (button) (small blind) collected ($1)
Seat 2: PrinceViktor (big blind) folded before Flop


*********** # 80 **************
PokerStars Zoom Hand #235751484348: Hold'em No Limit ($025/$050) - 2022/04/26 15:28:06 ET
Table 'C Carinae' 2-max Seat #1 is the button
Seat 1: xRhythm ($6654 in chips)
Seat 2: Lorpugo ($1507 in chips)
xRhythm: posts small blind $025
Lorpugo: posts big blind $050
*** HOLE CARDS ***
Dealt to Lorpugo [8h Ad]
xRhythm: raises $075 to $125
Lorpugo: raises $250 to $375
xRhythm: folds
Uncalled bet ($250) returned to Lorpugo
Lorpugo collected $250 from pot
Lorpugo: doesn't show hand
*** SUMMARY ***
Total pot $250 | Rake $0
Seat 1: xRhythm (button) (small blind) folded before Flop
Seat 2: Lorpugo (big blind) collected ($250)


*********** # 81 **************
PokerStars Zoom Hand #235751457526: Hold'em No Limit ($025/$050) - 2022/04/26 15:26:55 ET
Table 'C Carinae' 2-max Seat #1 is the button
Seat 1: Lorpugo ($26 in chips)
Seat 2: E N L 22 ($5892 in chips)
Lorpugo: posts small blind $025
E N L 22: posts big blind $050
*** HOLE CARDS ***
Dealt to Lorpugo [Qs 4d]
Lorpugo: raises $050 to $1
E N L 22: calls $050
*** FLOP *** [5s 3s 7d]
E N L 22: checks
Lorpugo: bets $090
E N L 22: calls $090
*** TURN *** [5s 3s 7d] [9d]
E N L 22: checks
Lorpugo: checks
*** RIVER *** [5s 3s 7d 9d] [Ah]
E N L 22: bets $361
Lorpugo: raises $542 to $903
E N L 22: raises $4799 to $5702 and is all-in
Lorpugo: folds
Uncalled bet ($4799) returned to E N L 22
E N L 22 collected $2092 from pot
E N L 22: doesn't show hand
*** SUMMARY ***
Total pot $2186 | Rake $094
Board [5s 3s 7d 9d Ah]
Seat 1: Lorpugo (button) (small blind) folded on the River
Seat 2: E N L 22 (big blind) collected ($2092)


*********** # 82 **************
PokerStars Zoom Hand #235751455308: Hold'em No Limit ($025/$050) - 2022/04/26 15:26:49 ET
Table 'C Carinae' 2-max Seat #1 is the button
Seat 1: karakoK10 ($5433 in chips)
Seat 2: Lorpugo ($2575 in chips)
karakoK10: posts small blind $025
Lorpugo: posts big blind $050
*** HOLE CARDS ***
Dealt to Lorpugo [Kh 6c]
karakoK10: folds
Uncalled bet ($025) returned to Lorpugo
Lorpugo collected $050 from pot
Lorpugo: doesn't show hand
*** SUMMARY ***
Total pot $050 | Rake $0
Seat 1: karakoK10 (button) (small blind) folded before Flop
Seat 2: Lorpugo (big blind) collected ($050)


*********** # 83 **************
PokerStars Zoom Hand #235751451055: Hold'em No Limit ($025/$050) - 2022/04/26 15:26:38 ET
Table 'C Carinae' 2-max Seat #1 is the button
Seat 1: Lorpugo ($2525 in chips)
Seat 2: karakoK10 ($5483 in chips)
Lorpugo: posts small blind $025
karakoK10: posts big blind $050
*** HOLE CARDS ***
Dealt to Lorpugo [Js Th]
Lorpugo: raises $060 to $110
karakoK10: folds
Uncalled bet ($060) returned to Lorpugo
Lorpugo collected $1 from pot
Lorpugo: doesn't show hand
*** SUMMARY ***
Total pot $1 | Rake $0
Seat 1: Lorpugo (button) (small blind) collected ($1)
Seat 2: karakoK10 (big blind) folded before Flop


*********** # 84 **************
PokerStars Zoom Hand #235751447762: Hold'em No Limit ($025/$050) - 2022/04/26 15:26:29 ET
Table 'C Carinae' 2-max Seat #1 is the button
Seat 1: luirian_1989 ($2563 in chips)
Seat 2: Lorpugo ($25 in chips)
luirian_1989: posts small blind $025
Lorpugo: posts big blind $050
*** HOLE CARDS ***
Dealt to Lorpugo [7s 3h]
luirian_1989: folds
Uncalled bet ($025) returned to Lorpugo
Lorpugo collected $050 from pot
Lorpugo: doesn't show hand
*** SUMMARY ***
Total pot $050 | Rake $0
Seat 1: luirian_1989 (button) (small blind) folded before Flop
Seat 2: Lorpugo (big blind) collected ($050)


*********** # 85 **************
PokerStars Zoom Hand #235751378460: Hold'em No Limit ($025/$050) - 2022/04/26 15:23:40 ET
Table 'C Carinae' 2-max Seat #1 is the button
Seat 1: Lorpugo ($2108 in chips)
Seat 2: Ares656 ($5320 in chips)
Lorpugo: posts small blind $025
Ares656: posts big blind $050
*** HOLE CARDS ***
Dealt to Lorpugo [3s Qd]
Lorpugo: raises $050 to $1
Ares656: calls $050
*** FLOP *** [6h 5s 9h]
Ares656: checks
Lorpugo: checks
*** TURN *** [6h 5s 9h] [Js]
Ares656: checks
Lorpugo: checks
*** RIVER *** [6h 5s 9h Js] [3c]
Ares656: checks
Lorpugo: checks
*** SHOW DOWN ***
Ares656: shows [8s 5c] (a pair of Fives)
Lorpugo: mucks hand
Ares656 collected $190 from pot
*** SUMMARY ***
Total pot $2 | Rake $010
Board [6h 5s 9h Js 3c]
Seat 1: Lorpugo (button) (small blind) mucked [3s Qd]
Seat 2: Ares656 (big blind) showed [8s 5c] and won ($190) with a pair of Fives


*********** # 86 **************
PokerStars Zoom Hand #235751353067: Hold'em No Limit ($025/$050) - 2022/04/26 15:22:35 ET
Table 'C Carinae' 2-max Seat #1 is the button
Seat 1: Lorpugo ($2812 in chips)
Seat 2: worldethos ($9705 in chips)
Lorpugo: posts small blind $025
worldethos: posts big blind $050
*** HOLE CARDS ***
Dealt to Lorpugo [Js 9s]
Lorpugo: raises $060 to $110
worldethos: raises $290 to $4
Lorpugo: calls $290
*** FLOP *** [6h 3h 2c]
worldethos: bets $304
Lorpugo: calls $304
*** TURN *** [6h 3h 2c] [3c]
worldethos: bets $883
Lorpugo: folds
Uncalled bet ($883) returned to worldethos
worldethos collected $1320 from pot
worldethos: doesn't show hand
*** SUMMARY ***
Total pot $1408 | Rake $088
Board [6h 3h 2c 3c]
Seat 1: Lorpugo (button) (small blind) folded on the Turn
Seat 2: worldethos (big blind) collected ($1320)


*********** # 87 **************
PokerStars Zoom Hand #235751346464: Hold'em No Limit ($025/$050) - 2022/04/26 15:22:18 ET
Table 'C Carinae' 2-max Seat #1 is the button
Seat 1: worldethos ($9655 in chips)
Seat 2: Lorpugo ($2862 in chips)
worldethos: posts small blind $025
Lorpugo: posts big blind $050
*** HOLE CARDS ***
Dealt to Lorpugo [Th 2c]
worldethos: raises $070 to $120
Lorpugo: folds
Uncalled bet ($070) returned to worldethos
worldethos collected $1 from pot
worldethos: doesn't show hand
*** SUMMARY ***
Total pot $1 | Rake $0
Seat 1: worldethos (button) (small blind) collected ($1)
Seat 2: Lorpugo (big blind) folded before Flop


*********** # 88 **************
PokerStars Zoom Hand #235751341446: Hold'em No Limit ($025/$050) - 2022/04/26 15:22:04 ET
Table 'C Carinae' 2-max Seat #1 is the button
Seat 1: Lorpugo ($2812 in chips)
Seat 2: worldethos ($9705 in chips)
Lorpugo: posts small blind $025
worldethos: posts big blind $050
*** HOLE CARDS ***
Dealt to Lorpugo [Ks Ah]
Lorpugo: raises $060 to $110
worldethos: folds
Uncalled bet ($060) returned to Lorpugo
Lorpugo collected $1 from pot
Lorpugo: doesn't show hand
*** SUMMARY ***
Total pot $1 | Rake $0
Seat 1: Lorpugo (button) (small blind) collected ($1)
Seat 2: worldethos (big blind) folded before Flop


*********** # 89 **************
PokerStars Zoom Hand #235751338470: Hold'em No Limit ($025/$050) - 2022/04/26 15:21:57 ET
Table 'C Carinae' 2-max Seat #1 is the button
Seat 1: karakoK10 ($4828 in chips)
Seat 2: Lorpugo ($2787 in chips)
karakoK10: posts small blind $025
Lorpugo: posts big blind $050
*** HOLE CARDS ***
Dealt to Lorpugo [7s 6c]
karakoK10: folds
Uncalled bet ($025) returned to Lorpugo
Lorpugo collected $050 from pot
Lorpugo: doesn't show hand
*** SUMMARY ***
Total pot $050 | Rake $0
Seat 1: karakoK10 (button) (small blind) folded before Flop
Seat 2: Lorpugo (big blind) collected ($050)


*********** # 90 **************
PokerStars Zoom Hand #235751319104: Hold'em No Limit ($025/$050) - 2022/04/26 15:21:06 ET
Table 'C Carinae' 2-max Seat #1 is the button
Seat 1: PrinceViktor ($5313 in chips)
Seat 2: Lorpugo ($2991 in chips)
PrinceViktor: posts small blind $025
Lorpugo: posts big blind $050
*** HOLE CARDS ***
Dealt to Lorpugo [6c 8h]
PrinceViktor: raises $075 to $125
Lorpugo: calls $075
*** FLOP *** [Jc 5c 4c]
Lorpugo: checks
PrinceViktor: bets $079
Lorpugo: calls $079
*** TURN *** [Jc 5c 4c] [9s]
Lorpugo: checks
PrinceViktor: bets $128
Lorpugo: folds
Uncalled bet ($128) returned to PrinceViktor
PrinceViktor collected $383 from pot
PrinceViktor: doesn't show hand
*** SUMMARY ***
Total pot $408 | Rake $025
Board [Jc 5c 4c 9s]
Seat 1: PrinceViktor (button) (small blind) collected ($383)
Seat 2: Lorpugo (big blind) folded on the Turn


*********** # 91 **************
PokerStars Zoom Hand #235751301687: Hold'em No Limit ($025/$050) - 2022/04/26 15:20:21 ET
Table 'C Carinae' 2-max Seat #1 is the button
Seat 1: Lorpugo ($2892 in chips)
Seat 2: gutsmnsglory ($6167 in chips)
Lorpugo: posts small blind $025
gutsmnsglory: posts big blind $050
*** HOLE CARDS ***
Dealt to Lorpugo [3d 4d]
Lorpugo: raises $060 to $110
gutsmnsglory: calls $060
*** FLOP *** [8h 9c 3s]
gutsmnsglory: checks
Lorpugo: bets $069
gutsmnsglory: folds
Uncalled bet ($069) returned to Lorpugo
Lorpugo collected $209 from pot
Lorpugo: doesn't show hand
*** SUMMARY ***
Total pot $220 | Rake $011
Board [8h 9c 3s]
Seat 1: Lorpugo (button) (small blind) collected ($209)
Seat 2: gutsmnsglory (big blind) folded on the Flop


*********** # 92 **************
PokerStars Zoom Hand #235751297874: Hold'em No Limit ($025/$050) - 2022/04/26 15:20:11 ET
Table 'C Carinae' 2-max Seat #1 is the button
Seat 1: Lorpugo ($2917 in chips)
Seat 2: BRoGeRZ ($3264 in chips)
Lorpugo: posts small blind $025
BRoGeRZ: posts big blind $050
*** HOLE CARDS ***
Dealt to Lorpugo [2h 6h]
Lorpugo: folds
Uncalled bet ($025) returned to BRoGeRZ
BRoGeRZ collected $050 from pot
BRoGeRZ: doesn't show hand
*** SUMMARY ***
Total pot $050 | Rake $0
Seat 1: Lorpugo (button) (small blind) folded before Flop
Seat 2: BRoGeRZ (big blind) collected ($050)


*********** # 93 **************
PokerStars Zoom Hand #235751295133: Hold'em No Limit ($025/$050) - 2022/04/26 15:20:04 ET
Table 'C Carinae' 2-max Seat #1 is the button
Seat 1: Alek791 ($3394 in chips)
Seat 2: Lorpugo ($2892 in chips)
Alek791: posts small blind $025
Lorpugo: posts big blind $050
*** HOLE CARDS ***
Dealt to Lorpugo [4c 5d]
Alek791: folds
Uncalled bet ($025) returned to Lorpugo
Lorpugo collected $050 from pot
Lorpugo: doesn't show hand
Alek791 is disconnected
*** SUMMARY ***
Total pot $050 | Rake $0
Seat 1: Alek791 (button) (small blind) folded before Flop
Seat 2: Lorpugo (big blind) collected ($050)


*********** # 94 **************
PokerStars Zoom Hand #235751280034: Hold'em No Limit ($025/$050) - 2022/04/26 15:19:24 ET
Table 'C Carinae' 2-max Seat #1 is the button
Seat 1: karakoK10 ($4898 in chips)
Seat 2: Lorpugo ($3092 in chips)
karakoK10: posts small blind $025
Lorpugo: posts big blind $050
*** HOLE CARDS ***
Dealt to Lorpugo [8d Jh]
karakoK10: raises $1 to $150
Lorpugo: calls $1
*** FLOP *** [5h 3c 2d]
Lorpugo: bets $050
karakoK10: calls $050
*** TURN *** [5h 3c 2d] [9d]
Lorpugo: checks
karakoK10: bets $209
Lorpugo: folds
Uncalled bet ($209) returned to karakoK10
karakoK10 collected $380 from pot
karakoK10: doesn't show hand
*** SUMMARY ***
Total pot $4 | Rake $020
Board [5h 3c 2d 9d]
Seat 1: karakoK10 (button) (small blind) collected ($380)
Seat 2: Lorpugo (big blind) folded on the Turn


*********** # 95 **************
PokerStars Zoom Hand #235751258656: Hold'em No Limit ($025/$050) - 2022/04/26 15:18:28 ET
Table 'C Carinae' 2-max Seat #1 is the button
Seat 1: Lorpugo ($1905 in chips)
Seat 2: karakoK10 ($50 in chips)
Lorpugo: posts small blind $025
karakoK10: posts big blind $050
*** HOLE CARDS ***
Dealt to Lorpugo [Qh Jh]
Lorpugo: raises $060 to $110
karakoK10: raises $290 to $4
Lorpugo: calls $290
*** FLOP *** [Qd 5d Jc]
karakoK10: checks
Lorpugo: checks
*** TURN *** [Qd 5d Jc] [Kh]
karakoK10: checks
Lorpugo: bets $375
karakoK10: calls $375
*** RIVER *** [Qd 5d Jc Kh] [Kc]
karakoK10: checks
Lorpugo: bets $487
karakoK10: calls $487
*** SHOW DOWN ***
Lorpugo: shows [Qh Jh] (two pair, Kings and Queens)
karakoK10: mucks hand
Lorpugo collected $2449 from pot
*** SUMMARY ***
Total pot $2524 | Rake $075
Board [Qd 5d Jc Kh Kc]
Seat 1: Lorpugo (button) (small blind) showed [Qh Jh] and won ($2449) with two pair, Kings and Queens
Seat 2: karakoK10 (big blind) mucked [Jd Ac]


*********** # 96 **************
PokerStars Zoom Hand #235751255964: Hold'em No Limit ($025/$050) - 2022/04/26 15:18:21 ET
Table 'C Carinae' 2-max Seat #1 is the button
Seat 1: Alek791 ($2763 in chips)
Seat 2: Lorpugo ($1880 in chips)
Alek791: posts small blind $025
Lorpugo: posts big blind $050
*** HOLE CARDS ***
Dealt to Lorpugo [Kc Js]
Alek791: folds
Uncalled bet ($025) returned to Lorpugo
Lorpugo collected $050 from pot
Lorpugo: doesn't show hand
Alek791 is disconnected
*** SUMMARY ***
Total pot $050 | Rake $0
Seat 1: Alek791 (button) (small blind) folded before Flop
Seat 2: Lorpugo (big blind) collected ($050)


*********** # 97 **************
PokerStars Zoom Hand #235751236381: Hold'em No Limit ($025/$050) - 2022/04/26 15:17:30 ET
Table 'C Carinae' 2-max Seat #1 is the button
Seat 1: Lorpugo ($1595 in chips)
Seat 2: E N L 22 ($3950 in chips)
Lorpugo: posts small blind $025
E N L 22: posts big blind $050
*** HOLE CARDS ***
Dealt to Lorpugo [Th 6s]
Lorpugo: raises $050 to $1
E N L 22: calls $050
*** FLOP *** [6c 6h 5s]
E N L 22: checks
Lorpugo: bets $095
E N L 22: calls $095
*** TURN *** [6c 6h 5s] [Js]
E N L 22: checks
Lorpugo: bets $122
E N L 22: calls $122
*** RIVER *** [6c 6h 5s Js] [Ac]
E N L 22: checks
Lorpugo: bets $1278 and is all-in
E N L 22: folds
Uncalled bet ($1278) returned to Lorpugo
Lorpugo collected $602 from pot
Lorpugo: doesn't show hand
E N L 22 is disconnected
*** SUMMARY ***
Total pot $634 | Rake $032
Board [6c 6h 5s Js Ac]
Seat 1: Lorpugo (button) (small blind) collected ($602)
Seat 2: E N L 22 (big blind) folded on the River


*********** # 98 **************
PokerStars Zoom Hand #235751223174: Hold'em No Limit ($025/$050) - 2022/04/26 15:16:55 ET
Table 'C Carinae' 2-max Seat #1 is the button
Seat 1: TheBluffPL ($10145 in chips)
Seat 2: Lorpugo ($1995 in chips)
TheBluffPL: posts small blind $025
Lorpugo: posts big blind $050
*** HOLE CARDS ***
Dealt to Lorpugo [4d Ac]
TheBluffPL: raises $075 to $125
Lorpugo: raises $275 to $4
TheBluffPL: raises $31 to $35
Lorpugo: folds
Uncalled bet ($31) returned to TheBluffPL
TheBluffPL collected $8 from pot
TheBluffPL: doesn't show hand
*** SUMMARY ***
Total pot $8 | Rake $0
Seat 1: TheBluffPL (button) (small blind) collected ($8)
Seat 2: Lorpugo (big blind) folded before Flop


*********** # 99 **************
PokerStars Zoom Hand #235751212630: Hold'em No Limit ($025/$050) - 2022/04/26 15:16:27 ET
Table 'C Carinae' 2-max Seat #1 is the button
Seat 1: Lorpugo ($2105 in chips)
Seat 2: xRhythm ($5238 in chips)
Lorpugo: posts small blind $025
xRhythm: posts big blind $050
*** HOLE CARDS ***
Dealt to Lorpugo [5d 7s]
Lorpugo: raises $060 to $110
xRhythm: raises $340 to $450
Lorpugo: folds
Uncalled bet ($340) returned to xRhythm
xRhythm collected $220 from pot
xRhythm: doesn't show hand
*** SUMMARY ***
Total pot $220 | Rake $0
Seat 1: Lorpugo (button) (small blind) folded before Flop
Seat 2: xRhythm (big blind) collected ($220)


*********** # 100 **************
PokerStars Zoom Hand #235751205344: Hold'em No Limit ($025/$050) - 2022/04/26 15:16:08 ET
Table 'C Carinae' 2-max Seat #1 is the button
Seat 1: PrinceViktor ($5345 in chips)
Seat 2: Lorpugo ($2155 in chips)
PrinceViktor: posts small blind $025
Lorpugo: posts big blind $050
*** HOLE CARDS ***
Dealt to Lorpugo [2s Kc]
PrinceViktor: raises $075 to $125
Lorpugo: folds
Uncalled bet ($075) returned to PrinceViktor
PrinceViktor collected $1 from pot
PrinceViktor: doesn't show hand
*** SUMMARY ***
Total pot $1 | Rake $0
Seat 1: PrinceViktor (button) (small blind) collected ($1)
Seat 2: Lorpugo (big blind) folded before Flop


*********** # 101 **************
PokerStars Zoom Hand #235751190031: Hold'em No Limit ($025/$050) - 2022/04/26 15:15:28 ET
Table 'C Carinae' 2-max Seat #1 is the button
Seat 1: Lorpugo ($2052 in chips)
Seat 2: PrinceViktor ($5261 in chips)
Lorpugo: posts small blind $025
PrinceViktor: posts big blind $050
*** HOLE CARDS ***
Dealt to Lorpugo [3s As]
Lorpugo: raises $065 to $115
PrinceViktor: calls $065
*** FLOP *** [3d 6h Ad]
PrinceViktor: checks
Lorpugo: bets $072
PrinceViktor: folds
Uncalled bet ($072) returned to Lorpugo
Lorpugo collected $218 from pot
Lorpugo: doesn't show hand
*** SUMMARY ***
Total pot $230 | Rake $012
Board [3d 6h Ad]
Seat 1: Lorpugo (button) (small blind) collected ($218)
Seat 2: PrinceViktor (big blind) folded on the Flop


*********** # 102 **************
PokerStars Zoom Hand #235751174951: Hold'em No Limit ($025/$050) - 2022/04/26 15:14:48 ET
Table 'C Carinae' 2-max Seat #1 is the button
Seat 1: MeryjanePL ($4823 in chips)
Seat 2: Lorpugo ($2202 in chips)
MeryjanePL: posts small blind $025
Lorpugo: posts big blind $050
*** HOLE CARDS ***
Dealt to Lorpugo [5h 3h]
MeryjanePL: raises $1 to $150
Lorpugo: calls $1
*** FLOP *** [Th 2s Ts]
Lorpugo: checks
MeryjanePL: bets $143
Lorpugo: folds
Uncalled bet ($143) returned to MeryjanePL
MeryjanePL collected $285 from pot
MeryjanePL: doesn't show hand
*** SUMMARY ***
Total pot $3 | Rake $015
Board [Th 2s Ts]
Seat 1: MeryjanePL (button) (small blind) collected ($285)
Seat 2: Lorpugo (big blind) folded on the Flop


*********** # 103 **************
PokerStars Zoom Hand #235751171734: Hold'em No Limit ($025/$050) - 2022/04/26 15:14:40 ET
Table 'C Carinae' 2-max Seat #1 is the button
Seat 1: Lorpugo ($2227 in chips)
Seat 2: MeryjanePL ($39 in chips)
Lorpugo: posts small blind $025
MeryjanePL: posts big blind $050
*** HOLE CARDS ***
Dealt to Lorpugo [4c 7s]
Lorpugo: folds
Uncalled bet ($025) returned to MeryjanePL
MeryjanePL collected $050 from pot
MeryjanePL: doesn't show hand
*** SUMMARY ***
Total pot $050 | Rake $0
Seat 1: Lorpugo (button) (small blind) folded before Flop
Seat 2: MeryjanePL (big blind) collected ($050)


*********** # 104 **************
PokerStars Zoom Hand #235751169115: Hold'em No Limit ($025/$050) - 2022/04/26 15:14:33 ET
Table 'C Carinae' 2-max Seat #1 is the button
Seat 1: jutswining ($5672 in chips)
Seat 2: Lorpugo ($2202 in chips)
jutswining: posts small blind $025
Lorpugo: posts big blind $050
*** HOLE CARDS ***
Dealt to Lorpugo [3s 8d]
jutswining: folds
Uncalled bet ($025) returned to Lorpugo
Lorpugo collected $050 from pot
Lorpugo: doesn't show hand
jutswining is disconnected
*** SUMMARY ***
Total pot $050 | Rake $0
Seat 1: jutswining (button) (small blind) folded before Flop
Seat 2: Lorpugo (big blind) collected ($050)


*********** # 105 **************
PokerStars Zoom Hand #235751164918: Hold'em No Limit ($025/$050) - 2022/04/26 15:14:22 ET
Table 'C Carinae' 2-max Seat #1 is the button
Seat 1: Lorpugo ($2152 in chips)
Seat 2: jutswining ($5722 in chips)
Lorpugo: posts small blind $025
jutswining: posts big blind $050
*** HOLE CARDS ***
Dealt to Lorpugo [4c 6s]
Lorpugo: raises $050 to $1
jutswining: folds
Uncalled bet ($050) returned to Lorpugo
Lorpugo collected $1 from pot
Lorpugo: doesn't show hand
jutswining is disconnected
*** SUMMARY ***
Total pot $1 | Rake $0
Seat 1: Lorpugo (button) (small blind) collected ($1)
Seat 2: jutswining (big blind) folded before Flop


*********** # 106 **************
PokerStars Zoom Hand #235751155327: Hold'em No Limit ($025/$050) - 2022/04/26 15:13:57 ET
Table 'C Carinae' 2-max Seat #1 is the button
Seat 1: Lorpugo ($2053 in chips)
Seat 2: jrborsec ($2424 in chips)
Lorpugo: posts small blind $025
jrborsec: posts big blind $050
*** HOLE CARDS ***
Dealt to Lorpugo [Ah As]
Lorpugo: raises $060 to $110
jrborsec: calls $060
*** FLOP *** [4d 5c 5h]
jrborsec: checks
Lorpugo: bets $110
jrborsec: folds
Uncalled bet ($110) returned to Lorpugo
Lorpugo collected $209 from pot
Lorpugo: doesn't show hand
jrborsec is disconnected
*** SUMMARY ***
Total pot $220 | Rake $011
Board [4d 5c 5h]
Seat 1: Lorpugo (button) (small blind) collected ($209)
Seat 2: jrborsec (big blind) folded on the Flop


*********** # 107 **************
PokerStars Zoom Hand #235751150080: Hold'em No Limit ($025/$050) - 2022/04/26 15:13:43 ET
Table 'C Carinae' 2-max Seat #1 is the button
Seat 1: Alek791 ($4336 in chips)
Seat 2: Lorpugo ($2103 in chips)
Alek791: posts small blind $025
Lorpugo: posts big blind $050
*** HOLE CARDS ***
Dealt to Lorpugo [Ts 4d]
Alek791: raises $050 to $1
Lorpugo: folds
Uncalled bet ($050) returned to Alek791
Alek791 collected $1 from pot
Alek791: doesn't show hand
*** SUMMARY ***
Total pot $1 | Rake $0
Seat 1: Alek791 (button) (small blind) collected ($1)
Seat 2: Lorpugo (big blind) folded before Flop


*********** # 108 **************
PokerStars Zoom Hand #235751144945: Hold'em No Limit ($025/$050) - 2022/04/26 15:13:29 ET
Table 'C Carinae' 2-max Seat #1 is the button
Seat 1: PrinceViktor ($50 in chips)
Seat 2: Lorpugo ($2153 in chips)
PrinceViktor: posts small blind $025
Lorpugo: posts big blind $050
*** HOLE CARDS ***
Dealt to Lorpugo [2d Js]
PrinceViktor: raises $075 to $125
Lorpugo: folds
Uncalled bet ($075) returned to PrinceViktor
PrinceViktor collected $1 from pot
PrinceViktor: doesn't show hand
*** SUMMARY ***
Total pot $1 | Rake $0
Seat 1: PrinceViktor (button) (small blind) collected ($1)
Seat 2: Lorpugo (big blind) folded before Flop


*********** # 109 **************
PokerStars Zoom Hand #235751140088: Hold'em No Limit ($025/$050) - 2022/04/26 15:13:16 ET
Table 'C Carinae' 2-max Seat #1 is the button
Seat 1: TheBluffPL ($5416 in chips)
Seat 2: Lorpugo ($2203 in chips)
TheBluffPL: posts small blind $025
Lorpugo: posts big blind $050
*** HOLE CARDS ***
Dealt to Lorpugo [6c 2h]
TheBluffPL: raises $075 to $125
Lorpugo: folds
Uncalled bet ($075) returned to TheBluffPL
TheBluffPL collected $1 from pot
TheBluffPL: doesn't show hand
*** SUMMARY ***
Total pot $1 | Rake $0
Seat 1: TheBluffPL (button) (small blind) collected ($1)
Seat 2: Lorpugo (big blind) folded before Flop


*********** # 110 **************
PokerStars Zoom Hand #235751134995: Hold'em No Limit ($025/$050) - 2022/04/26 15:13:02 ET
Table 'C Carinae' 2-max Seat #1 is the button
Seat 1: Lorpugo ($2153 in chips)
Seat 2: TheBluffPL ($5466 in chips)
Lorpugo: posts small blind $025
TheBluffPL: posts big blind $050
*** HOLE CARDS ***
Dealt to Lorpugo [7c 9d]
Lorpugo: raises $070 to $120
TheBluffPL: folds
Uncalled bet ($070) returned to Lorpugo
Lorpugo collected $1 from pot
Lorpugo: doesn't show hand
*** SUMMARY ***
Total pot $1 | Rake $0
Seat 1: Lorpugo (button) (small blind) collected ($1)
Seat 2: TheBluffPL (big blind) folded before Flop


*********** # 111 **************
PokerStars Zoom Hand #235751130989: Hold'em No Limit ($025/$050) - 2022/04/26 15:12:51 ET
Table 'C Carinae' 2-max Seat #1 is the button
Seat 1: Lorpugo ($2103 in chips)
Seat 2: karakoK10 ($5671 in chips)
Lorpugo: posts small blind $025
karakoK10: posts big blind $050
*** HOLE CARDS ***
Dealt to Lorpugo [7d 7h]
Lorpugo: raises $060 to $110
karakoK10: folds
Uncalled bet ($060) returned to Lorpugo
Lorpugo collected $1 from pot
Lorpugo: doesn't show hand
*** SUMMARY ***
Total pot $1 | Rake $0
Seat 1: Lorpugo (button) (small blind) collected ($1)
Seat 2: karakoK10 (big blind) folded before Flop


*********** # 112 **************
PokerStars Zoom Hand #235751097747: Hold'em No Limit ($025/$050) - 2022/04/26 15:11:46 ET
Table 'C Carinae' 2-max Seat #1 is the button
Seat 1: karakoK10 ($5682 in chips)
Seat 2: Lorpugo ($2113 in chips)
karakoK10: posts small blind $025
Lorpugo: posts big blind $050
*** HOLE CARDS ***
Dealt to Lorpugo [Jh 3h]
karakoK10: calls $025
Lorpugo: checks
*** FLOP *** [4d 7d 3s]
Lorpugo: checks
karakoK10: checks
*** TURN *** [4d 7d 3s] [Js]
Lorpugo: bets $160
karakoK10: calls $160
*** RIVER *** [4d 7d 3s Js] [7c]
Lorpugo: checks
karakoK10: checks
*** SHOW DOWN ***
Lorpugo: shows [Jh 3h] (two pair, Jacks and Sevens)
karakoK10: shows [Jd 2d] (two pair, Jacks and Sevens)
Lorpugo collected $2 from pot
karakoK10 collected $199 from pot
*** SUMMARY ***
Total pot $420 | Rake $021
Board [4d 7d 3s Js 7c]
Seat 1: karakoK10 (button) (small blind) showed [Jd 2d] and won ($199) with two pair, Jacks and Sevens
Seat 2: Lorpugo (big blind) showed [Jh 3h] and won ($2) with two pair, Jacks and Sevens


*********** # 113 **************
PokerStars Zoom Hand #235751059206: Hold'em No Limit ($025/$050) - 2022/04/26 15:10:04 ET
Table 'C Carinae' 2-max Seat #1 is the button
Seat 1: Lorpugo ($3330 in chips)
Seat 2: TheBluffPL ($50 in chips)
Lorpugo: posts small blind $025
TheBluffPL: posts big blind $050
*** HOLE CARDS ***
Dealt to Lorpugo [Jc 4c]
Lorpugo: raises $060 to $110
TheBluffPL: calls $060
*** FLOP *** [Th 7d Ks]
TheBluffPL: checks
Lorpugo: checks
*** TURN *** [Th 7d Ks] [Qs]
TheBluffPL: bets $157
Lorpugo: calls $157
*** RIVER *** [Th 7d Ks Qs] [7h]
TheBluffPL: bets $380
Lorpugo: raises $570 to $950
TheBluffPL: raises $3783 to $4733 and is all-in
Lorpugo: folds
Uncalled bet ($3783) returned to TheBluffPL
TheBluffPL collected $2359 from pot
TheBluffPL: doesn't show hand
*** SUMMARY ***
Total pot $2434 | Rake $075
Board [Th 7d Ks Qs 7h]
Seat 1: Lorpugo (button) (small blind) folded on the River
Seat 2: TheBluffPL (big blind) collected ($2359)


*********** # 114 **************
PokerStars Zoom Hand #235751051562: Hold'em No Limit ($025/$050) - 2022/04/26 15:09:44 ET
Table 'C Carinae' 2-max Seat #1 is the button
Seat 1: TheBluffPL ($5125 in chips)
Seat 2: Lorpugo ($3205 in chips)
TheBluffPL: posts small blind $025
Lorpugo: posts big blind $050
*** HOLE CARDS ***
Dealt to Lorpugo [9h 9d]
TheBluffPL: raises $075 to $125
Lorpugo: raises $275 to $4
TheBluffPL: folds
Uncalled bet ($275) returned to Lorpugo
Lorpugo collected $250 from pot
Lorpugo: doesn't show hand
*** SUMMARY ***
Total pot $250 | Rake $0
Seat 1: TheBluffPL (button) (small blind) folded before Flop
Seat 2: Lorpugo (big blind) collected ($250)


*********** # 115 **************
PokerStars Zoom Hand #235751039632: Hold'em No Limit ($025/$050) - 2022/04/26 15:09:12 ET
Table 'C Carinae' 2-max Seat #1 is the button
Seat 1: Lorpugo ($3315 in chips)
Seat 2: worldethos ($5081 in chips)
Lorpugo: posts small blind $025
worldethos: posts big blind $050
*** HOLE CARDS ***
Dealt to Lorpugo [Ad 9s]
Lorpugo: raises $060 to $110
worldethos: raises $240 to $350
Lorpugo: folds
Uncalled bet ($240) returned to worldethos
worldethos collected $220 from pot
worldethos: doesn't show hand
*** SUMMARY ***
Total pot $220 | Rake $0
Seat 1: Lorpugo (button) (small blind) folded before Flop
Seat 2: worldethos (big blind) collected ($220)


*********** # 116 **************
PokerStars Zoom Hand #235751005097: Hold'em No Limit ($025/$050) - 2022/04/26 15:07:40 ET
Table 'C Carinae' 2-max Seat #1 is the button
Seat 1: worldethos ($5292 in chips)
Seat 2: Lorpugo ($3125 in chips)
worldethos: posts small blind $025
Lorpugo: posts big blind $050
*** HOLE CARDS ***
Dealt to Lorpugo [Jd 4d]
worldethos: raises $070 to $120
Lorpugo: calls $070
*** FLOP *** [4h 9c 9h]
Lorpugo: checks
worldethos: bets $091
Lorpugo: calls $091
*** TURN *** [4h 9c 9h] [5c]
Lorpugo: checks
worldethos: checks
*** RIVER *** [4h 9c 9h 5c] [Qd]
Lorpugo: checks
worldethos: checks
*** SHOW DOWN ***
Lorpugo: shows [Jd 4d] (two pair, Nines and Fours)
worldethos: mucks hand
Lorpugo collected $401 from pot
*** SUMMARY ***
Total pot $422 | Rake $021
Board [4h 9c 9h 5c Qd]
Seat 1: worldethos (button) (small blind) mucked [6d Tc]
Seat 2: Lorpugo (big blind) showed [Jd 4d] and won ($401) with two pair, Nines and Fours


*********** # 117 **************
PokerStars Zoom Hand #235750995411: Hold'em No Limit ($025/$050) - 2022/04/26 15:07:14 ET
Table 'C Carinae' 2-max Seat #1 is the button
Seat 1: Lorpugo ($3241 in chips)
Seat 2: TheBluffPL ($5572 in chips)
Lorpugo: posts small blind $025
TheBluffPL: posts big blind $050
*** HOLE CARDS ***
Dealt to Lorpugo [Qc 4c]
Lorpugo: raises $066 to $116
TheBluffPL: raises $384 to $5
Lorpugo: folds
Uncalled bet ($384) returned to TheBluffPL
TheBluffPL collected $232 from pot
TheBluffPL: doesn't show hand
*** SUMMARY ***
Total pot $232 | Rake $0
Seat 1: Lorpugo (button) (small blind) folded before Flop
Seat 2: TheBluffPL (big blind) collected ($232)


*********** # 118 **************
PokerStars Zoom Hand #235750976133: Hold'em No Limit ($025/$050) - 2022/04/26 15:06:23 ET
Table 'C Carinae' 2-max Seat #1 is the button
Seat 1: E N L 22 ($8355 in chips)
Seat 2: Lorpugo ($3341 in chips)
E N L 22: posts small blind $025
Lorpugo: posts big blind $050
*** HOLE CARDS ***
Dealt to Lorpugo [7h Th]
E N L 22: calls $025
Lorpugo: checks
*** FLOP *** [7s Kd 6c]
Lorpugo: checks
E N L 22: checks
*** TURN *** [7s Kd 6c] [5h]
Lorpugo: bets $050
E N L 22: calls $050
*** RIVER *** [7s Kd 6c 5h] [9h]
Lorpugo: checks
E N L 22: checks
*** SHOW DOWN ***
Lorpugo: shows [7h Th] (a pair of Sevens)
E N L 22: shows [9d Jc] (a pair of Nines)
E N L 22 collected $188 from pot
*** SUMMARY ***
Total pot $2 | Rake $012
Board [7s Kd 6c 5h 9h]
Seat 1: E N L 22 (button) (small blind) showed [9d Jc] and won ($188) with a pair of Nines
Seat 2: Lorpugo (big blind) showed [7h Th] and lost with a pair of Sevens


*********** # 119 **************
PokerStars Zoom Hand #235750969720: Hold'em No Limit ($025/$050) - 2022/04/26 15:06:06 ET
Table 'C Carinae' 2-max Seat #1 is the button
Seat 1: Lorpugo ($3291 in chips)
Seat 2: MeryjanePL ($5523 in chips)
Lorpugo: posts small blind $025
MeryjanePL: posts big blind $050
*** HOLE CARDS ***
Dealt to Lorpugo [6c Kh]
Lorpugo: raises $060 to $110
MeryjanePL: folds
Uncalled bet ($060) returned to Lorpugo
Lorpugo collected $1 from pot
Lorpugo: doesn't show hand
*** SUMMARY ***
Total pot $1 | Rake $0
Seat 1: Lorpugo (button) (small blind) collected ($1)
Seat 2: MeryjanePL (big blind) folded before Flop


*********** # 120 **************
PokerStars Zoom Hand #235750945636: Hold'em No Limit ($025/$050) - 2022/04/26 15:05:01 ET
Table 'C Carinae' 2-max Seat #1 is the button
Seat 1: MeryjanePL ($5369 in chips)
Seat 2: Lorpugo ($3462 in chips)
MeryjanePL: posts small blind $025
Lorpugo: posts big blind $050
*** HOLE CARDS ***
Dealt to Lorpugo [4d 8d]
MeryjanePL: raises $055 to $105
Lorpugo: calls $055
*** FLOP *** [3d 9d Ah]
Lorpugo: checks
MeryjanePL: bets $066
Lorpugo: calls $066
*** TURN *** [3d 9d Ah] [Ts]
Lorpugo: checks
MeryjanePL: checks
*** RIVER *** [3d 9d Ah Ts] [Kc]
Lorpugo: checks
MeryjanePL: checks
*** SHOW DOWN ***
Lorpugo: shows [4d 8d] (high card Ace)
MeryjanePL: shows [Ks 5c] (a pair of Kings)
MeryjanePL collected $325 from pot
*** SUMMARY ***
Total pot $342 | Rake $017
Board [3d 9d Ah Ts Kc]
Seat 1: MeryjanePL (button) (small blind) showed [Ks 5c] and won ($325) with a pair of Kings
Seat 2: Lorpugo (big blind) showed [4d 8d] and lost with high card Ace


*********** # 121 **************
PokerStars Zoom Hand #235750941537: Hold'em No Limit ($025/$050) - 2022/04/26 15:04:50 ET
Table 'C Carinae' 2-max Seat #1 is the button
Seat 1: Lorpugo ($3487 in chips)
Seat 2: karakoK10 ($5511 in chips)
Lorpugo: posts small blind $025
karakoK10: posts big blind $050
*** HOLE CARDS ***
Dealt to Lorpugo [Ts 4c]
Lorpugo: folds
Uncalled bet ($025) returned to karakoK10
karakoK10 collected $050 from pot
karakoK10: doesn't show hand
*** SUMMARY ***
Total pot $050 | Rake $0
Seat 1: Lorpugo (button) (small blind) folded before Flop
Seat 2: karakoK10 (big blind) collected ($050)


*********** # 122 **************
PokerStars Zoom Hand #235750939244: Hold'em No Limit ($025/$050) - 2022/04/26 15:04:43 ET
Table 'C Carinae' 2-max Seat #1 is the button
Seat 1: Ares656 ($7774 in chips)
Seat 2: Lorpugo ($3462 in chips)
Ares656: posts small blind $025
Lorpugo: posts big blind $050
*** HOLE CARDS ***
Dealt to Lorpugo [8s 9h]
Ares656: folds
Uncalled bet ($025) returned to Lorpugo
Lorpugo collected $050 from pot
Lorpugo: doesn't show hand
*** SUMMARY ***
Total pot $050 | Rake $0
Seat 1: Ares656 (button) (small blind) folded before Flop
Seat 2: Lorpugo (big blind) collected ($050)


*********** # 123 **************
PokerStars Zoom Hand #235750936488: Hold'em No Limit ($025/$050) - 2022/04/26 15:04:36 ET
Table 'C Carinae' 2-max Seat #1 is the button
Seat 1: Lorpugo ($3487 in chips)
Seat 2: MagicViuff ($7843 in chips)
Lorpugo: posts small blind $025
MagicViuff: posts big blind $050
*** HOLE CARDS ***
Dealt to Lorpugo [Ts 4c]
Lorpugo: folds
Uncalled bet ($025) returned to MagicViuff
MagicViuff collected $050 from pot
MagicViuff: doesn't show hand
*** SUMMARY ***
Total pot $050 | Rake $0
Seat 1: Lorpugo (button) (small blind) folded before Flop
Seat 2: MagicViuff (big blind) collected ($050)


*********** # 124 **************
PokerStars Zoom Hand #235750933759: Hold'em No Limit ($025/$050) - 2022/04/26 15:04:28 ET
Table 'C Carinae' 2-max Seat #1 is the button
Seat 1: Ethernion ($9842 in chips)
Seat 2: Lorpugo ($3462 in chips)
Ethernion: posts small blind $025
Lorpugo: posts big blind $050
*** HOLE CARDS ***
Dealt to Lorpugo [5c Ks]
Ethernion: folds
Uncalled bet ($025) returned to Lorpugo
Lorpugo collected $050 from pot
Lorpugo: doesn't show hand
*** SUMMARY ***
Total pot $050 | Rake $0
Seat 1: Ethernion (button) (small blind) folded before Flop
Seat 2: Lorpugo (big blind) collected ($050)


*********** # 125 **************
PokerStars Zoom Hand #235750900900: Hold'em No Limit ($025/$050) - 2022/04/26 15:03:12 ET
Table 'C Carinae' 2-max Seat #1 is the button
Seat 1: MeryjanePL ($5127 in chips)
Seat 2: Lorpugo ($3644 in chips)
MeryjanePL: posts small blind $025
Lorpugo: posts big blind $050
*** HOLE CARDS ***
Dealt to Lorpugo [8s Tc]
MeryjanePL: raises $075 to $125
Lorpugo: calls $075
*** FLOP *** [3s Qd 4s]
Lorpugo: checks
MeryjanePL: bets $057
Lorpugo: calls $057
*** TURN *** [3s Qd 4s] [7d]
Lorpugo: checks
MeryjanePL: checks
*** RIVER *** [3s Qd 4s 7d] [Js]
Lorpugo: checks
MeryjanePL: checks
*** SHOW DOWN ***
Lorpugo: shows [8s Tc] (high card Queen)
MeryjanePL: shows [Kd Th] (high card King)
MeryjanePL collected $346 from pot
*** SUMMARY ***
Total pot $364 | Rake $018
Board [3s Qd 4s 7d Js]
Seat 1: MeryjanePL (button) (small blind) showed [Kd Th] and won ($346) with high card King
Seat 2: Lorpugo (big blind) showed [8s Tc] and lost with high card Queen


*********** # 126 **************
PokerStars Zoom Hand #235750897315: Hold'em No Limit ($025/$050) - 2022/04/26 15:03:02 ET
Table 'C Carinae' 2-max Seat #1 is the button
Seat 1: Lorpugo ($3669 in chips)
Seat 2: jutswining ($11520 in chips)
Lorpugo: posts small blind $025
jutswining: posts big blind $050
*** HOLE CARDS ***
Dealt to Lorpugo [9d 3s]
Lorpugo: folds
Uncalled bet ($025) returned to jutswining
jutswining collected $050 from pot
jutswining: doesn't show hand
*** SUMMARY ***
Total pot $050 | Rake $0
Seat 1: Lorpugo (button) (small blind) folded before Flop
Seat 2: jutswining (big blind) collected ($050)


*********** # 127 **************
PokerStars Zoom Hand #235750868350: Hold'em No Limit ($025/$050) - 2022/04/26 15:01:42 ET
Table 'C Carinae' 2-max Seat #1 is the button
Seat 1: Lorpugo ($3376 in chips)
Seat 2: xRhythm ($6052 in chips)
Lorpugo: posts small blind $025
xRhythm: posts big blind $050
*** HOLE CARDS ***
Dealt to Lorpugo [4s As]
Lorpugo: raises $060 to $110
xRhythm: calls $060
*** FLOP *** [3d Js Jc]
xRhythm: checks
Lorpugo: bets $069
xRhythm: raises $146 to $215
Lorpugo: calls $146
*** TURN *** [3d Js Jc] [Qh]
xRhythm: checks
Lorpugo: bets $260
xRhythm: folds
Uncalled bet ($260) returned to Lorpugo
Lorpugo collected $618 from pot
Lorpugo: doesn't show hand
*** SUMMARY ***
Total pot $650 | Rake $032
Board [3d Js Jc Qh]
Seat 1: Lorpugo (button) (small blind) collected ($618)
Seat 2: xRhythm (big blind) folded on the Turn


*********** # 128 **************
PokerStars Zoom Hand #235750853401: Hold'em No Limit ($025/$050) - 2022/04/26 15:00:56 ET
Table 'C Carinae' 2-max Seat #1 is the button
Seat 1: Lorpugo ($3129 in chips)
Seat 2: Niclazzz ($3612 in chips)
Lorpugo: posts small blind $025
Niclazzz: posts big blind $050
*** HOLE CARDS ***
Dealt to Lorpugo [5h Kh]
Lorpugo: raises $060 to $110
Niclazzz: calls $060
*** FLOP *** [6s Kc 6h]
Niclazzz: checks
Lorpugo: bets $069
Niclazzz: calls $069
*** TURN *** [6s Kc 6h] [Ad]
Niclazzz: checks
Lorpugo: bets $095
Niclazzz: calls $095
*** RIVER *** [6s Kc 6h Ad] [6c]
Niclazzz: checks
Lorpugo: checks
*** SHOW DOWN ***
Niclazzz: shows [3h 3d] (a full house, Sixes full of Threes)
Lorpugo: shows [5h Kh] (a full house, Sixes full of Kings)
Lorpugo collected $521 from pot
*** SUMMARY ***
Total pot $548 | Rake $027
Board [6s Kc 6h Ad 6c]
Seat 1: Lorpugo (button) (small blind) showed [5h Kh] and won ($521) with a full house, Sixes full of Kings
Seat 2: Niclazzz (big blind) showed [3h 3d] and lost with a full house, Sixes full of Threes


*********** # 129 **************
PokerStars Zoom Hand #235750843443: Hold'em No Limit ($025/$050) - 2022/04/26 15:00:23 ET
Table 'C Carinae' 2-max Seat #1 is the button
Seat 1: Niclazzz ($4062 in chips)
Seat 2: Lorpugo ($2724 in chips)
Niclazzz: posts small blind $025
Lorpugo: posts big blind $050
*** HOLE CARDS ***
Dealt to Lorpugo [Jd Js]
Niclazzz: raises $1 to $150
Lorpugo: raises $3 to $450
Niclazzz: calls $3
*** FLOP *** [3d 3h Kh]
Lorpugo: bets $282
Niclazzz: folds
Uncalled bet ($282) returned to Lorpugo
Lorpugo collected $855 from pot
Lorpugo: doesn't show hand
Niclazzz is disconnected
*** SUMMARY ***
Total pot $9 | Rake $045
Board [3d 3h Kh]
Seat 1: Niclazzz (button) (small blind) folded on the Flop
Seat 2: Lorpugo (big blind) collected ($855)


*********** # 130 **************
PokerStars Zoom Hand #235750835754: Hold'em No Limit ($025/$050) - 2022/04/26 14:59:56 ET
Table 'C Carinae' 2-max Seat #1 is the button
Seat 1: iulian3000 ($6709 in chips)
Seat 2: Lorpugo ($2575 in chips)
iulian3000: posts small blind $025
Lorpugo: posts big blind $050
*** HOLE CARDS ***
Dealt to Lorpugo [9s Ah]
iulian3000: calls $025
Lorpugo: raises $115 to $165
iulian3000: calls $115
*** FLOP *** [2s Tc 7h]
Lorpugo: bets $104
iulian3000: folds
Uncalled bet ($104) returned to Lorpugo
Lorpugo collected $314 from pot
Lorpugo: doesn't show hand
*** SUMMARY ***
Total pot $330 | Rake $016
Board [2s Tc 7h]
Seat 1: iulian3000 (button) (small blind) folded on the Flop
Seat 2: Lorpugo (big blind) collected ($314)


*********** # 131 **************
PokerStars Zoom Hand #235750832405: Hold'em No Limit ($025/$050) - 2022/04/26 14:59:44 ET
Table 'C Carinae' 2-max Seat #1 is the button
Seat 1: Lorpugo ($2525 in chips)
Seat 2: worldethos ($50 in chips)
Lorpugo: posts small blind $025
worldethos: posts big blind $050
*** HOLE CARDS ***
Dealt to Lorpugo [5h 8s]
Lorpugo: raises $050 to $1
worldethos: folds
Uncalled bet ($050) returned to Lorpugo
Lorpugo collected $1 from pot
Lorpugo: doesn't show hand
*** SUMMARY ***
Total pot $1 | Rake $0
Seat 1: Lorpugo (button) (small blind) collected ($1)
Seat 2: worldethos (big blind) folded before Flop


*********** # 132 **************
PokerStars Zoom Hand #235750830075: Hold'em No Limit ($025/$050) - 2022/04/26 14:59:36 ET
Table 'C Carinae' 2-max Seat #1 is the button
Seat 1: Niclazzz ($3999 in chips)
Seat 2: Lorpugo ($25 in chips)
Niclazzz: posts small blind $025
Lorpugo: posts big blind $050
*** HOLE CARDS ***
Dealt to Lorpugo [Qd 3d]
Niclazzz: folds
Uncalled bet ($025) returned to Lorpugo
Lorpugo collected $050 from pot
Lorpugo: doesn't show hand
Niclazzz is disconnected
*** SUMMARY ***
Total pot $050 | Rake $0
Seat 1: Niclazzz (button) (small blind) folded before Flop
Seat 2: Lorpugo (big blind) collected ($050)


*********** # 133 **************
PokerStars Zoom Hand #235750828744: Hold'em No Limit ($025/$050) - 2022/04/26 14:59:31 ET
Table 'C Carinae' 2-max Seat #1 is the button
Seat 1: Ares656 ($5238 in chips)
Seat 2: Lorpugo ($2475 in chips)
Ares656: posts small blind $025
Lorpugo: posts big blind $050
*** HOLE CARDS ***
Dealt to Lorpugo [Qc Th]
Ares656: folds
Uncalled bet ($025) returned to Lorpugo
Lorpugo collected $050 from pot
Lorpugo: doesn't show hand
*** SUMMARY ***
Total pot $050 | Rake $0
Seat 1: Ares656 (button) (small blind) folded before Flop
Seat 2: Lorpugo (big blind) collected ($050)


*********** # 134 **************
PokerStars Zoom Hand #235750826462: Hold'em No Limit ($025/$050) - 2022/04/26 14:59:23 ET
Table 'C Carinae' 2-max Seat #1 is the button
Seat 1: Lorpugo ($25 in chips)
Seat 2: MeryjanePL ($50 in chips)
Lorpugo: posts small blind $025
MeryjanePL: posts big blind $050
*** HOLE CARDS ***
Dealt to Lorpugo [4d 7h]
Lorpugo: folds
Uncalled bet ($025) returned to MeryjanePL
MeryjanePL collected $050 from pot
MeryjanePL: doesn't show hand
*** SUMMARY ***
Total pot $050 | Rake $0
Seat 1: Lorpugo (button) (small blind) folded before Flop
Seat 2: MeryjanePL (big blind) collected ($050)


*********** # 135 **************
PokerStars Zoom Hand #235750815090: Hold'em No Limit ($025/$050) - 2022/04/26 14:58:42 ET
Table 'C Carinae' 2-max Seat #1 is the button
Seat 1: Lorpugo ($2221 in chips)
Seat 2: MeryjanePL ($6413 in chips)
Lorpugo: posts small blind $025
MeryjanePL: posts big blind $050
*** HOLE CARDS ***
Dealt to Lorpugo [Ad Ks]
Lorpugo: raises $050 to $1
MeryjanePL: raises $3 to $4
Lorpugo: raises $1821 to $2221 and is all-in
MeryjanePL: calls $1821
*** FLOP *** [Qc 2d Ac]
*** TURN *** [Qc 2d Ac] [Jh]
*** RIVER *** [Qc 2d Ac Jh] [3d]
*** SHOW DOWN ***
MeryjanePL: shows [As Ah] (three of a kind, Aces)
Lorpugo: shows [Ad Ks] (a pair of Aces)
MeryjanePL collected $4367 from pot
*** SUMMARY ***
Total pot $4442 | Rake $075
Board [Qc 2d Ac Jh 3d]
Seat 1: Lorpugo (button) (small blind) showed [Ad Ks] and lost with a pair of Aces
Seat 2: MeryjanePL (big blind) showed [As Ah] and won ($4367) with three of a kind, Aces


*********** # 136 **************
PokerStars Zoom Hand #235750810982: Hold'em No Limit ($025/$050) - 2022/04/26 14:58:27 ET
Table 'C Carinae' 2-max Seat #1 is the button
Seat 1: Niclazzz ($3718 in chips)
Seat 2: Lorpugo ($2271 in chips)
Niclazzz: posts small blind $025
Lorpugo: posts big blind $050
*** HOLE CARDS ***
Dealt to Lorpugo [2s 8d]
Niclazzz: raises $1 to $150
Lorpugo: folds
Uncalled bet ($1) returned to Niclazzz
Niclazzz collected $1 from pot
Niclazzz: doesn't show hand
*** SUMMARY ***
Total pot $1 | Rake $0
Seat 1: Niclazzz (button) (small blind) collected ($1)
Seat 2: Lorpugo (big blind) folded before Flop


*********** # 137 **************
PokerStars Zoom Hand #235750804623: Hold'em No Limit ($025/$050) - 2022/04/26 14:58:04 ET
Table 'C Carinae' 2-max Seat #1 is the button
Seat 1: Lorpugo ($2371 in chips)
Seat 2: 3bet4win9 ($4437 in chips)
Lorpugo: posts small blind $025
3bet4win9: posts big blind $050
*** HOLE CARDS ***
Dealt to Lorpugo [6d Qh]
Lorpugo: raises $050 to $1
3bet4win9: raises $4337 to $4437 and is all-in
Lorpugo: folds
Uncalled bet ($4337) returned to 3bet4win9
3bet4win9 collected $2 from pot
3bet4win9: doesn't show hand
3bet4win9 is disconnected
*** SUMMARY ***
Total pot $2 | Rake $0
Seat 1: Lorpugo (button) (small blind) folded before Flop
Seat 2: 3bet4win9 (big blind) collected ($2)


*********** # 138 **************
PokerStars Zoom Hand #235750802938: Hold'em No Limit ($025/$050) - 2022/04/26 14:57:58 ET
Table 'C Carinae' 2-max Seat #1 is the button
Seat 1: karakoK10 ($7052 in chips)
Seat 2: Lorpugo ($2346 in chips)
karakoK10: posts small blind $025
Lorpugo: posts big blind $050
*** HOLE CARDS ***
Dealt to Lorpugo [9c 2s]
karakoK10: folds
Uncalled bet ($025) returned to Lorpugo
Lorpugo collected $050 from pot
Lorpugo: doesn't show hand
*** SUMMARY ***
Total pot $050 | Rake $0
Seat 1: karakoK10 (button) (small blind) folded before Flop
Seat 2: Lorpugo (big blind) collected ($050)


*********** # 139 **************
PokerStars Zoom Hand #235750799519: Hold'em No Limit ($025/$050) - 2022/04/26 14:57:46 ET
Table 'C Carinae' 2-max Seat #1 is the button
Seat 1: Lorpugo ($2296 in chips)
Seat 2: karakoK10 ($7102 in chips)
Lorpugo: posts small blind $025
karakoK10: posts big blind $050
*** HOLE CARDS ***
Dealt to Lorpugo [5s 7d]
Lorpugo: raises $050 to $1
karakoK10: folds
Uncalled bet ($050) returned to Lorpugo
Lorpugo collected $1 from pot
Lorpugo: doesn't show hand
*** SUMMARY ***
Total pot $1 | Rake $0
Seat 1: Lorpugo (button) (small blind) collected ($1)
Seat 2: karakoK10 (big blind) folded before Flop


*********** # 140 **************
PokerStars Zoom Hand #235750779135: Hold'em No Limit ($025/$050) - 2022/04/26 14:56:33 ET
Table 'C Carinae' 2-max Seat #1 is the button
Seat 1: karakoK10 ($6918 in chips)
Seat 2: Lorpugo ($25 in chips)
karakoK10: posts small blind $025
Lorpugo: posts big blind $050
*** HOLE CARDS ***
Dealt to Lorpugo [Ah 4h]
karakoK10: raises $075 to $125
Lorpugo: calls $075
*** FLOP *** [5c 5s 7d]
Lorpugo: checks
karakoK10: bets $079
Lorpugo: calls $079
*** TURN *** [5c 5s 7d] [8d]
Lorpugo: checks
karakoK10: checks
*** RIVER *** [5c 5s 7d 8d] [9h]
Lorpugo: checks
karakoK10: checks
*** SHOW DOWN ***
Lorpugo: shows [Ah 4h] (a pair of Fives)
karakoK10: shows [Jd Ad] (a pair of Fives - Ace+Jack kicker)
karakoK10 collected $388 from pot
*** SUMMARY ***
Total pot $408 | Rake $020
Board [5c 5s 7d 8d 9h]
Seat 1: karakoK10 (button) (small blind) showed [Jd Ad] and won ($388) with a pair of Fives
Seat 2: Lorpugo (big blind) showed [Ah 4h] and lost with a pair of Fives


*********** # 141 **************
PokerStars Zoom Hand #235732180958: Hold'em No Limit ($025/$050) - 2022/04/25 16:22:14 ET
Table 'C Carinae' 2-max Seat #1 is the button
Seat 1: Lorpugo ($2997 in chips)
Seat 2: Dougpolk27997 ($50 in chips)
Lorpugo: posts small blind $025
Dougpolk27997: posts big blind $050
*** HOLE CARDS ***
Dealt to Lorpugo [As 8c]
Lorpugo: raises $060 to $110
Dougpolk27997: calls $060
*** FLOP *** [Qc Jd 5d]
Dougpolk27997: checks
Lorpugo: bets $050
Dougpolk27997: folds
Uncalled bet ($050) returned to Lorpugo
Lorpugo collected $209 from pot
Lorpugo: doesn't show hand
*** SUMMARY ***
Total pot $220 | Rake $011
Board [Qc Jd 5d]
Seat 1: Lorpugo (button) (small blind) collected ($209)
Seat 2: Dougpolk27997 (big blind) folded on the Flop


*********** # 142 **************
PokerStars Zoom Hand #235732148083: Hold'em No Limit ($025/$050) - 2022/04/25 16:21:18 ET
Table 'C Carinae' 2-max Seat #1 is the button
Seat 1: MeryjanePL ($5077 in chips)
Seat 2: Lorpugo ($2862 in chips)
MeryjanePL: posts small blind $025
Lorpugo: posts big blind $050
*** HOLE CARDS ***
Dealt to Lorpugo [Jc Th]
MeryjanePL: calls $025
Lorpugo: raises $1 to $150
MeryjanePL: calls $1
*** FLOP *** [6s Qs Qh]
Lorpugo: checks
MeryjanePL: checks
*** TURN *** [6s Qs Qh] [3c]
Lorpugo: bets $090
MeryjanePL: folds
Uncalled bet ($090) returned to Lorpugo
Lorpugo collected $285 from pot
Lorpugo: doesn't show hand
*** SUMMARY ***
Total pot $3 | Rake $015
Board [6s Qs Qh 3c]
Seat 1: MeryjanePL (button) (small blind) folded on the Turn
Seat 2: Lorpugo (big blind) collected ($285)


*********** # 143 **************
PokerStars Zoom Hand #235732137133: Hold'em No Limit ($025/$050) - 2022/04/25 16:20:53 ET
Table 'C Carinae' 2-max Seat #1 is the button
Seat 1: Lorpugo ($2982 in chips)
Seat 2: lilyjackvs1 ($50 in chips)
Lorpugo: posts small blind $025
lilyjackvs1: posts big blind $050
*** HOLE CARDS ***
Dealt to Lorpugo [Jc 9h]
Lorpugo: raises $070 to $120
lilyjackvs1: raises $280 to $4
Lorpugo: folds
Uncalled bet ($280) returned to lilyjackvs1
lilyjackvs1 collected $240 from pot
lilyjackvs1: doesn't show hand
*** SUMMARY ***
Total pot $240 | Rake $0
Seat 1: Lorpugo (button) (small blind) folded before Flop
Seat 2: lilyjackvs1 (big blind) collected ($240)


*********** # 144 **************
PokerStars Zoom Hand #235732129575: Hold'em No Limit ($025/$050) - 2022/04/25 16:20:36 ET
Table 'C Carinae' 2-max Seat #1 is the button
Seat 1: Lorpugo ($2932 in chips)
Seat 2: Dougpolk27997 ($5155 in chips)
Lorpugo: posts small blind $025
Dougpolk27997: posts big blind $050
*** HOLE CARDS ***
Dealt to Lorpugo [Jc 5h]
Lorpugo: raises $055 to $105
Dougpolk27997: folds
Uncalled bet ($055) returned to Lorpugo
Lorpugo collected $1 from pot
Lorpugo: doesn't show hand
*** SUMMARY ***
Total pot $1 | Rake $0
Seat 1: Lorpugo (button) (small blind) collected ($1)
Seat 2: Dougpolk27997 (big blind) folded before Flop


*********** # 145 **************
PokerStars Zoom Hand #235732123866: Hold'em No Limit ($025/$050) - 2022/04/25 16:20:23 ET
Table 'C Carinae' 2-max Seat #1 is the button
Seat 1: Dougpolk27997 ($5105 in chips)
Seat 2: Lorpugo ($2982 in chips)
Dougpolk27997: posts small blind $025
Lorpugo: posts big blind $050
*** HOLE CARDS ***
Dealt to Lorpugo [5s 2h]
Dougpolk27997: raises $075 to $125
Lorpugo: folds
Uncalled bet ($075) returned to Dougpolk27997
Dougpolk27997 collected $1 from pot
Dougpolk27997: doesn't show hand
*** SUMMARY ***
Total pot $1 | Rake $0
Seat 1: Dougpolk27997 (button) (small blind) collected ($1)
Seat 2: Lorpugo (big blind) folded before Flop


*********** # 146 **************
PokerStars Zoom Hand #235732114864: Hold'em No Limit ($025/$050) - 2022/04/25 16:20:02 ET
Table 'C Carinae' 2-max Seat #1 is the button
Seat 1: Lorpugo ($3087 in chips)
Seat 2: Dougpolk27997 ($50 in chips)
Lorpugo: posts small blind $025
Dougpolk27997: posts big blind $050
*** HOLE CARDS ***
Dealt to Lorpugo [4h 4d]
Lorpugo: raises $055 to $105
Dougpolk27997: raises $395 to $5
Lorpugo: folds
Uncalled bet ($395) returned to Dougpolk27997
Dougpolk27997 collected $210 from pot
Dougpolk27997: doesn't show hand
*** SUMMARY ***
Total pot $210 | Rake $0
Seat 1: Lorpugo (button) (small blind) folded before Flop
Seat 2: Dougpolk27997 (big blind) collected ($210)


*********** # 147 **************
PokerStars Zoom Hand #235732111801: Hold'em No Limit ($025/$050) - 2022/04/25 16:19:55 ET
Table 'C Carinae' 2-max Seat #1 is the button
Seat 1: Dougpolk27997 ($50 in chips)
Seat 2: Lorpugo ($3062 in chips)
Dougpolk27997: posts small blind $025
Lorpugo: posts big blind $050
*** HOLE CARDS ***
Dealt to Lorpugo [5h Qc]
Dougpolk27997: folds
Uncalled bet ($025) returned to Lorpugo
Lorpugo collected $050 from pot
Lorpugo: doesn't show hand
*** SUMMARY ***
Total pot $050 | Rake $0
Seat 1: Dougpolk27997 (button) (small blind) folded before Flop
Seat 2: Lorpugo (big blind) collected ($050)


*********** # 148 **************
PokerStars Zoom Hand #235732095611: Hold'em No Limit ($025/$050) - 2022/04/25 16:19:17 ET
Table 'C Carinae' 2-max Seat #1 is the button
Seat 1: Lorpugo ($2963 in chips)
Seat 2: MeryjanePL ($5209 in chips)
Lorpugo: posts small blind $025
MeryjanePL: posts big blind $050
*** HOLE CARDS ***
Dealt to Lorpugo [As Ad]
Lorpugo: raises $060 to $110
MeryjanePL: calls $060
*** FLOP *** [5h 5s Tc]
MeryjanePL: checks
Lorpugo: bets $1
MeryjanePL: folds
Uncalled bet ($1) returned to Lorpugo
Lorpugo collected $209 from pot
Lorpugo: doesn't show hand
*** SUMMARY ***
Total pot $220 | Rake $011
Board [5h 5s Tc]
Seat 1: Lorpugo (button) (small blind) collected ($209)
Seat 2: MeryjanePL (big blind) folded on the Flop


*********** # 149 **************
PokerStars Zoom Hand #235732087566: Hold'em No Limit ($025/$050) - 2022/04/25 16:19:01 ET
Table 'C Carinae' 2-max Seat #1 is the button
Seat 1: Lorpugo ($2913 in chips)
Seat 2: lucaslucas7 ($8157 in chips)
Lorpugo: posts small blind $025
lucaslucas7: posts big blind $050
*** HOLE CARDS ***
Dealt to Lorpugo [Jh Jc]
Lorpugo: raises $075 to $125
lucaslucas7: folds
Uncalled bet ($075) returned to Lorpugo
Lorpugo collected $1 from pot
Lorpugo: doesn't show hand
*** SUMMARY ***
Total pot $1 | Rake $0
Seat 1: Lorpugo (button) (small blind) collected ($1)
Seat 2: lucaslucas7 (big blind) folded before Flop


*********** # 150 **************
PokerStars Zoom Hand #235732080242: Hold'em No Limit ($025/$050) - 2022/04/25 16:18:43 ET
Table 'C Carinae' 2-max Seat #1 is the button
Seat 1: samoooth ($16289 in chips)
Seat 2: Lorpugo ($2963 in chips)
samoooth: posts small blind $025
Lorpugo: posts big blind $050
*** HOLE CARDS ***
Dealt to Lorpugo [2s 8c]
samoooth: raises $075 to $125
Lorpugo: folds
Uncalled bet ($075) returned to samoooth
samoooth collected $1 from pot
samoooth: doesn't show hand
*** SUMMARY ***
Total pot $1 | Rake $0
Seat 1: samoooth (button) (small blind) collected ($1)
Seat 2: Lorpugo (big blind) folded before Flop


*********** # 151 **************
PokerStars Zoom Hand #235732038791: Hold'em No Limit ($025/$050) - 2022/04/25 16:17:08 ET
Table 'C Carinae' 2-max Seat #1 is the button
Seat 1: lilyjackvs1 ($6315 in chips)
Seat 2: Lorpugo ($2743 in chips)
lilyjackvs1: posts small blind $025
Lorpugo: posts big blind $050
*** HOLE CARDS ***
Dealt to Lorpugo [Ac 6c]
lilyjackvs1: raises $075 to $125
Lorpugo: calls $075
*** FLOP *** [Qh Ad 2c]
Lorpugo: checks
lilyjackvs1: bets $119
Lorpugo: calls $119
*** TURN *** [Qh Ad 2c] [6d]
Lorpugo: checks
lilyjackvs1: checks
*** RIVER *** [Qh Ad 2c 6d] [3s]
Lorpugo: bets $153
lilyjackvs1: folds
Uncalled bet ($153) returned to Lorpugo
Lorpugo collected $464 from pot
Lorpugo: doesn't show hand
*** SUMMARY ***
Total pot $488 | Rake $024
Board [Qh Ad 2c 6d 3s]
Seat 1: lilyjackvs1 (button) (small blind) folded on the River
Seat 2: Lorpugo (big blind) collected ($464)


*********** # 152 **************
PokerStars Zoom Hand #235732024442: Hold'em No Limit ($025/$050) - 2022/04/25 16:16:35 ET
Table 'C Carinae' 2-max Seat #1 is the button
Seat 1: Lorpugo ($2509 in chips)
Seat 2: lilyjackvs1 ($6575 in chips)
Lorpugo: posts small blind $025
lilyjackvs1: posts big blind $050
*** HOLE CARDS ***
Dealt to Lorpugo [6c 6d]
Lorpugo: raises $060 to $110
lilyjackvs1: calls $060
*** FLOP *** [8c 6h Ad]
lilyjackvs1: bets $150
Lorpugo: raises $250 to $4
lilyjackvs1: folds
Uncalled bet ($250) returned to Lorpugo
Lorpugo collected $494 from pot
Lorpugo: doesn't show hand
*** SUMMARY ***
Total pot $520 | Rake $026
Board [8c 6h Ad]
Seat 1: Lorpugo (button) (small blind) collected ($494)
Seat 2: lilyjackvs1 (big blind) folded on the Flop


*********** # 153 **************
PokerStars Zoom Hand #235732020528: Hold'em No Limit ($025/$050) - 2022/04/25 16:16:26 ET
Table 'C Carinae' 2-max Seat #1 is the button
Seat 1: sinzza5 ($4129 in chips)
Seat 2: Lorpugo ($2484 in chips)
sinzza5: posts small blind $025
Lorpugo: posts big blind $050
*** HOLE CARDS ***
Dealt to Lorpugo [Jc 7d]
sinzza5: folds
Uncalled bet ($025) returned to Lorpugo
Lorpugo collected $050 from pot
Lorpugo: doesn't show hand
sinzza5 is disconnected
*** SUMMARY ***
Total pot $050 | Rake $0
Seat 1: sinzza5 (button) (small blind) folded before Flop
Seat 2: Lorpugo (big blind) collected ($050)


*********** # 154 **************
PokerStars Zoom Hand #235732014311: Hold'em No Limit ($025/$050) - 2022/04/25 16:16:12 ET
Table 'C Carinae' 2-max Seat #1 is the button
Seat 1: mInImalIst9 ($51 in chips)
Seat 2: Lorpugo ($2534 in chips)
mInImalIst9: posts small blind $025
Lorpugo: posts big blind $050
*** HOLE CARDS ***
Dealt to Lorpugo [6c 4h]
mInImalIst9: raises $075 to $125
Lorpugo: folds
Uncalled bet ($075) returned to mInImalIst9
mInImalIst9 collected $1 from pot
mInImalIst9: doesn't show hand
*** SUMMARY ***
Total pot $1 | Rake $0
Seat 1: mInImalIst9 (button) (small blind) collected ($1)
Seat 2: Lorpugo (big blind) folded before Flop


*********** # 155 **************
PokerStars Zoom Hand #235732000522: Hold'em No Limit ($025/$050) - 2022/04/25 16:15:40 ET
Table 'C Carinae' 2-max Seat #1 is the button
Seat 1: Lorpugo ($2644 in chips)
Seat 2: mInImalIst9 ($50 in chips)
Lorpugo: posts small blind $025
mInImalIst9: posts big blind $050
*** HOLE CARDS ***
Dealt to Lorpugo [8d Qd]
Lorpugo: raises $060 to $110
mInImalIst9: raises $290 to $4
Lorpugo: folds
Uncalled bet ($290) returned to mInImalIst9
mInImalIst9 collected $220 from pot
mInImalIst9: doesn't show hand
*** SUMMARY ***
Total pot $220 | Rake $0
Seat 1: Lorpugo (button) (small blind) folded before Flop
Seat 2: mInImalIst9 (big blind) collected ($220)


*********** # 156 **************
PokerStars Zoom Hand #235731998383: Hold'em No Limit ($025/$050) - 2022/04/25 16:15:35 ET
Table 'C Carinae' 2-max Seat #1 is the button
Seat 1: samoooth ($5739 in chips)
Seat 2: Lorpugo ($2619 in chips)
samoooth: posts small blind $025
Lorpugo: posts big blind $050
*** HOLE CARDS ***
Dealt to Lorpugo [Ts 6h]
samoooth: folds
Uncalled bet ($025) returned to Lorpugo
Lorpugo collected $050 from pot
Lorpugo: doesn't show hand
*** SUMMARY ***
Total pot $050 | Rake $0
Seat 1: samoooth (button) (small blind) folded before Flop
Seat 2: Lorpugo (big blind) collected ($050)


*********** # 157 **************
PokerStars Zoom Hand #235731973087: Hold'em No Limit ($025/$050) - 2022/04/25 16:14:46 ET
Table 'C Carinae' 2-max Seat #1 is the button
Seat 1: erik1337 ($11345 in chips)
Seat 2: Lorpugo ($1941 in chips)
erik1337: posts small blind $025
Lorpugo: posts big blind $050
*** HOLE CARDS ***
Dealt to Lorpugo [Ts Kd]
erik1337: raises $060 to $110
Lorpugo: raises $220 to $330
erik1337: calls $220
*** FLOP *** [9d 5s 5c]
Lorpugo: bets $165
erik1337: raises $258 to $423
Lorpugo: raises $1188 to $1611 and is all-in
erik1337: folds
Uncalled bet ($1188) returned to Lorpugo
Lorpugo collected $1431 from pot
Lorpugo: doesn't show hand
*** SUMMARY ***
Total pot $1506 | Rake $075
Board [9d 5s 5c]
Seat 1: erik1337 (button) (small blind) folded on the Flop
Seat 2: Lorpugo (big blind) collected ($1431)


*********** # 158 **************
PokerStars Zoom Hand #235731948191: Hold'em No Limit ($025/$050) - 2022/04/25 16:13:47 ET
Table 'C Carinae' 2-max Seat #1 is the button
Seat 1: erik1337 ($11523 in chips)
Seat 2: Lorpugo ($1781 in chips)
erik1337: posts small blind $025
Lorpugo: posts big blind $050
*** HOLE CARDS ***
Dealt to Lorpugo [8c Th]
erik1337: raises $060 to $110
Lorpugo: calls $060
*** FLOP *** [Tc Td 7c]
Lorpugo: checks
erik1337: checks
*** TURN *** [Tc Td 7c] [Ah]
Lorpugo: checks
erik1337: checks
*** RIVER *** [Tc Td 7c Ah] [3h]
Lorpugo: bets $068
erik1337: calls $068
*** SHOW DOWN ***
Lorpugo: shows [8c Th] (three of a kind, Tens)
erik1337: mucks hand
Lorpugo collected $338 from pot
*** SUMMARY ***
Total pot $356 | Rake $018
Board [Tc Td 7c Ah 3h]
Seat 1: erik1337 (button) (small blind) mucked [Kh Qs]
Seat 2: Lorpugo (big blind) showed [8c Th] and won ($338) with three of a kind, Tens


*********** # 159 **************
PokerStars Zoom Hand #235731943668: Hold'em No Limit ($025/$050) - 2022/04/25 16:13:36 ET
Table 'C Carinae' 2-max Seat #1 is the button
Seat 1: Lorpugo ($1731 in chips)
Seat 2: lilyjackvs1 ($7030 in chips)
Lorpugo: posts small blind $025
lilyjackvs1: posts big blind $050
*** HOLE CARDS ***
Dealt to Lorpugo [Ad Th]
Lorpugo: raises $060 to $110
lilyjackvs1: folds
Uncalled bet ($060) returned to Lorpugo
Lorpugo collected $1 from pot
Lorpugo: doesn't show hand
*** SUMMARY ***
Total pot $1 | Rake $0
Seat 1: Lorpugo (button) (small blind) collected ($1)
Seat 2: lilyjackvs1 (big blind) folded before Flop


*********** # 160 **************
PokerStars Zoom Hand #235731924548: Hold'em No Limit ($025/$050) - 2022/04/25 16:12:51 ET
Table 'C Carinae' 2-max Seat #1 is the button
Seat 1: Lorpugo ($1896 in chips)
Seat 2: EkimM1978 ($2639 in chips)
Lorpugo: posts small blind $025
EkimM1978: posts big blind $050
*** HOLE CARDS ***
Dealt to Lorpugo [7h Ah]
Lorpugo: raises $065 to $115
EkimM1978: calls $065
*** FLOP *** [6h Jh Qd]
EkimM1978: checks
Lorpugo: checks
*** TURN *** [6h Jh Qd] [3c]
EkimM1978: bets $050
Lorpugo: calls $050
*** RIVER *** [6h Jh Qd 3c] [3d]
EkimM1978: bets $3
Lorpugo: folds
Uncalled bet ($3) returned to EkimM1978
EkimM1978 collected $310 from pot
EkimM1978: doesn't show hand
*** SUMMARY ***
Total pot $330 | Rake $020
Board [6h Jh Qd 3c 3d]
Seat 1: Lorpugo (button) (small blind) folded on the River
Seat 2: EkimM1978 (big blind) collected ($310)


*********** # 161 **************
PokerStars Zoom Hand #235731917799: Hold'em No Limit ($025/$050) - 2022/04/25 16:12:35 ET
Table 'C Carinae' 2-max Seat #1 is the button
Seat 1: Lorpugo ($1846 in chips)
Seat 2: lucaslucas7 ($6248 in chips)
Lorpugo: posts small blind $025
lucaslucas7: posts big blind $050
*** HOLE CARDS ***
Dealt to Lorpugo [Kh Kc]
Lorpugo: raises $060 to $110
lucaslucas7: folds
Uncalled bet ($060) returned to Lorpugo
Lorpugo collected $1 from pot
Lorpugo: doesn't show hand
*** SUMMARY ***
Total pot $1 | Rake $0
Seat 1: Lorpugo (button) (small blind) collected ($1)
Seat 2: lucaslucas7 (big blind) folded before Flop


*********** # 162 **************
PokerStars Zoom Hand #235731909255: Hold'em No Limit ($025/$050) - 2022/04/25 16:12:15 ET
Table 'C Carinae' 2-max Seat #1 is the button
Seat 1: Lorpugo ($1796 in chips)
Seat 2: lucaslucas7 ($6298 in chips)
Lorpugo: posts small blind $025
lucaslucas7: posts big blind $050
*** HOLE CARDS ***
Dealt to Lorpugo [Ts 7s]
Lorpugo: raises $065 to $115
lucaslucas7: folds
Uncalled bet ($065) returned to Lorpugo
Lorpugo collected $1 from pot
Lorpugo: doesn't show hand
*** SUMMARY ***
Total pot $1 | Rake $0
Seat 1: Lorpugo (button) (small blind) collected ($1)
Seat 2: lucaslucas7 (big blind) folded before Flop


*********** # 163 **************
PokerStars Zoom Hand #235731889151: Hold'em No Limit ($025/$050) - 2022/04/25 16:11:40 ET
Table 'C Carinae' 2-max Seat #1 is the button
Seat 1: sinzza5 ($4365 in chips)
Seat 2: Lorpugo ($1846 in chips)
sinzza5: posts small blind $025
Lorpugo: posts big blind $050
*** HOLE CARDS ***
Dealt to Lorpugo [Jc 3c]
sinzza5: raises $2 to $250
Lorpugo: folds
Uncalled bet ($2) returned to sinzza5
sinzza5 collected $1 from pot
sinzza5: doesn't show hand
*** SUMMARY ***
Total pot $1 | Rake $0
Seat 1: sinzza5 (button) (small blind) collected ($1)
Seat 2: Lorpugo (big blind) folded before Flop


*********** # 164 **************
PokerStars Zoom Hand #235731885165: Hold'em No Limit ($025/$050) - 2022/04/25 16:11:31 ET
Table 'C Carinae' 2-max Seat #1 is the button
Seat 1: OverCologne ($5785 in chips)
Seat 2: Lorpugo ($1896 in chips)
OverCologne: posts small blind $025
Lorpugo: posts big blind $050
*** HOLE CARDS ***
Dealt to Lorpugo [5c 7d]
OverCologne: raises $075 to $125
Lorpugo: folds
Uncalled bet ($075) returned to OverCologne
OverCologne collected $1 from pot
OverCologne: doesn't show hand
*** SUMMARY ***
Total pot $1 | Rake $0
Seat 1: OverCologne (button) (small blind) collected ($1)
Seat 2: Lorpugo (big blind) folded before Flop


*********** # 165 **************
PokerStars Zoom Hand #235731863004: Hold'em No Limit ($025/$050) - 2022/04/25 16:10:38 ET
Table 'C Carinae' 2-max Seat #1 is the button
Seat 1: Lorpugo ($2356 in chips)
Seat 2: erik1337 ($10894 in chips)
Lorpugo: posts small blind $025
erik1337: posts big blind $050
*** HOLE CARDS ***
Dealt to Lorpugo [6s 5c]
Lorpugo: raises $050 to $1
erik1337: calls $050
*** FLOP *** [Jc 8d 3d]
erik1337: checks
Lorpugo: checks
*** TURN *** [Jc 8d 3d] [2h]
erik1337: checks
Lorpugo: bets $155
erik1337: calls $155
*** RIVER *** [Jc 8d 3d 2h] [7d]
erik1337: checks
Lorpugo: bets $205
erik1337: raises $10434 to $10639 and is all-in
Lorpugo: folds
Uncalled bet ($10434) returned to erik1337
erik1337 collected $874 from pot
erik1337: doesn't show hand
*** SUMMARY ***
Total pot $920 | Rake $046
Board [Jc 8d 3d 2h 7d]
Seat 1: Lorpugo (button) (small blind) folded on the River
Seat 2: erik1337 (big blind) collected ($874)


*********** # 166 **************
PokerStars Zoom Hand #235731837123: Hold'em No Limit ($025/$050) - 2022/04/25 16:09:37 ET
Table 'C Carinae' 2-max Seat #1 is the button
Seat 1: lucaslucas7 ($6673 in chips)
Seat 2: Lorpugo ($2221 in chips)
lucaslucas7: posts small blind $025
Lorpugo: posts big blind $050
*** HOLE CARDS ***
Dealt to Lorpugo [7h 5d]
lucaslucas7: calls $025
Lorpugo: checks
*** FLOP *** [5s Jc Ac]
Lorpugo: checks
lucaslucas7: checks
*** TURN *** [5s Jc Ac] [5h]
Lorpugo: bets $1
lucaslucas7: calls $1
*** RIVER *** [5s Jc Ac 5h] [Kc]
Lorpugo: checks
lucaslucas7: checks
*** SHOW DOWN ***
Lorpugo: shows [7h 5d] (three of a kind, Fives)
lucaslucas7: mucks hand
Lorpugo collected $285 from pot
*** SUMMARY ***
Total pot $3 | Rake $015
Board [5s Jc Ac 5h Kc]
Seat 1: lucaslucas7 (button) (small blind) mucked [Jd 2d]
Seat 2: Lorpugo (big blind) showed [7h 5d] and won ($285) with three of a kind, Fives


*********** # 167 **************
PokerStars Zoom Hand #235731828465: Hold'em No Limit ($025/$050) - 2022/04/25 16:09:16 ET
Table 'C Carinae' 2-max Seat #1 is the button
Seat 1: Lorpugo ($2171 in chips)
Seat 2: lucaslucas7 ($9024 in chips)
Lorpugo: posts small blind $025
lucaslucas7: posts big blind $050
*** HOLE CARDS ***
Dealt to Lorpugo [Ad 4h]
Lorpugo: raises $060 to $110
lucaslucas7: folds
Uncalled bet ($060) returned to Lorpugo
Lorpugo collected $1 from pot
Lorpugo: doesn't show hand
*** SUMMARY ***
Total pot $1 | Rake $0
Seat 1: Lorpugo (button) (small blind) collected ($1)
Seat 2: lucaslucas7 (big blind) folded before Flop


*********** # 168 **************
PokerStars Zoom Hand #235731821227: Hold'em No Limit ($025/$050) - 2022/04/25 16:08:59 ET
Table 'C Carinae' 2-max Seat #1 is the button
Seat 1: lucaslucas7 ($6523 in chips)
Seat 2: Lorpugo ($2221 in chips)
lucaslucas7: posts small blind $025
Lorpugo: posts big blind $050
*** HOLE CARDS ***
Dealt to Lorpugo [7s 2c]
lucaslucas7: raises $075 to $125
Lorpugo: folds
Uncalled bet ($075) returned to lucaslucas7
lucaslucas7 collected $1 from pot
lucaslucas7: doesn't show hand
*** SUMMARY ***
Total pot $1 | Rake $0
Seat 1: lucaslucas7 (button) (small blind) collected ($1)
Seat 2: Lorpugo (big blind) folded before Flop


*********** # 169 **************
PokerStars Zoom Hand #235731810310: Hold'em No Limit ($025/$050) - 2022/04/25 16:08:34 ET
Table 'C Carinae' 2-max Seat #1 is the button
Seat 1: Lorpugo ($2346 in chips)
Seat 2: min_ace ($6346 in chips)
Lorpugo: posts small blind $025
min_ace: posts big blind $050
*** HOLE CARDS ***
Dealt to Lorpugo [As 2c]
Lorpugo: raises $075 to $125
min_ace: calls $075
*** FLOP *** [3c 6s 5h]
min_ace: bets $119
Lorpugo: folds
Uncalled bet ($119) returned to min_ace
min_ace collected $238 from pot
min_ace: doesn't show hand
*** SUMMARY ***
Total pot $250 | Rake $012
Board [3c 6s 5h]
Seat 1: Lorpugo (button) (small blind) folded on the Flop
Seat 2: min_ace (big blind) collected ($238)


*********** # 170 **************
PokerStars Zoom Hand #235731802360: Hold'em No Limit ($025/$050) - 2022/04/25 16:08:15 ET
Table 'C Carinae' 2-max Seat #1 is the button
Seat 1: lilyjackvs1 ($50 in chips)
Seat 2: Lorpugo ($2221 in chips)
lilyjackvs1: posts small blind $025
Lorpugo: posts big blind $050
*** HOLE CARDS ***
Dealt to Lorpugo [Tc 6c]
lilyjackvs1: raises $075 to $125
Lorpugo: raises $250 to $375
lilyjackvs1: folds
Uncalled bet ($250) returned to Lorpugo
Lorpugo collected $250 from pot
Lorpugo: doesn't show hand
*** SUMMARY ***
Total pot $250 | Rake $0
Seat 1: lilyjackvs1 (button) (small blind) folded before Flop
Seat 2: Lorpugo (big blind) collected ($250)


*********** # 171 **************
PokerStars Zoom Hand #235731795585: Hold'em No Limit ($025/$050) - 2022/04/25 16:07:59 ET
Table 'C Carinae' 2-max Seat #1 is the button
Seat 1: Lorpugo ($2171 in chips)
Seat 2: zukmens ($6648 in chips)
Lorpugo: posts small blind $025
zukmens: posts big blind $050
*** HOLE CARDS ***
Dealt to Lorpugo [Kd 2c]
Lorpugo: raises $075 to $125
zukmens: folds
Uncalled bet ($075) returned to Lorpugo
Lorpugo collected $1 from pot
Lorpugo: doesn't show hand
*** SUMMARY ***
Total pot $1 | Rake $0
Seat 1: Lorpugo (button) (small blind) collected ($1)
Seat 2: zukmens (big blind) folded before Flop


*********** # 172 **************
PokerStars Zoom Hand #235731788804: Hold'em No Limit ($025/$050) - 2022/04/25 16:07:43 ET
Table 'C Carinae' 2-max Seat #1 is the button
Seat 1: samoooth ($5150 in chips)
Seat 2: Lorpugo ($2071 in chips)
samoooth: posts small blind $025
Lorpugo: posts big blind $050
*** HOLE CARDS ***
Dealt to Lorpugo [Kd Kc]
samoooth: raises $050 to $1
Lorpugo: raises $2 to $3
samoooth: folds
Uncalled bet ($2) returned to Lorpugo
Lorpugo collected $2 from pot
Lorpugo: doesn't show hand
*** SUMMARY ***
Total pot $2 | Rake $0
Seat 1: samoooth (button) (small blind) folded before Flop
Seat 2: Lorpugo (big blind) collected ($2)


*********** # 173 **************
PokerStars Zoom Hand #235731784132: Hold'em No Limit ($025/$050) - 2022/04/25 16:07:32 ET
Table 'C Carinae' 2-max Seat #1 is the button
Seat 1: Lorpugo ($2096 in chips)
Seat 2: lucaslucas7 ($9157 in chips)
Lorpugo: posts small blind $025
lucaslucas7: posts big blind $050
*** HOLE CARDS ***
Dealt to Lorpugo [9h 3d]
Lorpugo: folds
Uncalled bet ($025) returned to lucaslucas7
lucaslucas7 collected $050 from pot
lucaslucas7: doesn't show hand
*** SUMMARY ***
Total pot $050 | Rake $0
Seat 1: Lorpugo (button) (small blind) folded before Flop
Seat 2: lucaslucas7 (big blind) collected ($050)


*********** # 174 **************
PokerStars Zoom Hand #235731769968: Hold'em No Limit ($025/$050) - 2022/04/25 16:06:59 ET
Table 'C Carinae' 2-max Seat #1 is the button
Seat 1: Lorpugo ($2216 in chips)
Seat 2: min_ace ($6048 in chips)
Lorpugo: posts small blind $025
min_ace: posts big blind $050
*** HOLE CARDS ***
Dealt to Lorpugo [8h Ts]
Lorpugo: raises $070 to $120
min_ace: calls $070
*** FLOP *** [2h 5c Kc]
min_ace: bets $114
Lorpugo: folds
Uncalled bet ($114) returned to min_ace
min_ace collected $228 from pot
min_ace: doesn't show hand
*** SUMMARY ***
Total pot $240 | Rake $012
Board [2h 5c Kc]
Seat 1: Lorpugo (button) (small blind) folded on the Flop
Seat 2: min_ace (big blind) collected ($228)


*********** # 175 **************
PokerStars Zoom Hand #235731759517: Hold'em No Limit ($025/$050) - 2022/04/25 16:06:34 ET
Table 'C Carinae' 2-max Seat #1 is the button
Seat 1: lucaslucas7 ($9017 in chips)
Seat 2: Lorpugo ($2266 in chips)
lucaslucas7: posts small blind $025
Lorpugo: posts big blind $050
*** HOLE CARDS ***
Dealt to Lorpugo [4d Kc]
lucaslucas7: calls $025
Lorpugo: checks
*** FLOP *** [Qd 5h 8c]
Lorpugo: checks
lucaslucas7: bets $050
Lorpugo: folds
Uncalled bet ($050) returned to lucaslucas7
lucaslucas7 collected $095 from pot
lucaslucas7: doesn't show hand
*** SUMMARY ***
Total pot $1 | Rake $005
Board [Qd 5h 8c]
Seat 1: lucaslucas7 (button) (small blind) collected ($095)
Seat 2: Lorpugo (big blind) folded on the Flop


*********** # 176 **************
PokerStars Zoom Hand #235731753829: Hold'em No Limit ($025/$050) - 2022/04/25 16:06:20 ET
Table 'C Carinae' 2-max Seat #1 is the button
Seat 1: OverCologne ($8980 in chips)
Seat 2: Lorpugo ($2316 in chips)
OverCologne: posts small blind $025
Lorpugo: posts big blind $050
*** HOLE CARDS ***
Dealt to Lorpugo [4s Ts]
OverCologne: raises $075 to $125
Lorpugo: folds
Uncalled bet ($075) returned to OverCologne
OverCologne collected $1 from pot
OverCologne: doesn't show hand
*** SUMMARY ***
Total pot $1 | Rake $0
Seat 1: OverCologne (button) (small blind) collected ($1)
Seat 2: Lorpugo (big blind) folded before Flop


*********** # 177 **************
PokerStars Zoom Hand #235731751322: Hold'em No Limit ($025/$050) - 2022/04/25 16:06:14 ET
Table 'C Carinae' 2-max Seat #1 is the button
Seat 1: erik1337 ($5025 in chips)
Seat 2: Lorpugo ($2366 in chips)
erik1337: posts small blind $025
Lorpugo: posts big blind $050
*** HOLE CARDS ***
Dealt to Lorpugo [5h 2d]
erik1337: raises $060 to $110
Lorpugo: folds
Uncalled bet ($060) returned to erik1337
erik1337 collected $1 from pot
erik1337: doesn't show hand
*** SUMMARY ***
Total pot $1 | Rake $0
Seat 1: erik1337 (button) (small blind) collected ($1)
Seat 2: Lorpugo (big blind) folded before Flop


*********** # 178 **************
PokerStars Zoom Hand #235731739403: Hold'em No Limit ($025/$050) - 2022/04/25 16:05:47 ET
Table 'C Carinae' 2-max Seat #1 is the button
Seat 1: Lorpugo ($2482 in chips)
Seat 2: sinzza5 ($4921 in chips)
Lorpugo: posts small blind $025
sinzza5: posts big blind $050
*** HOLE CARDS ***
Dealt to Lorpugo [Ac 8s]
Lorpugo: raises $066 to $116
sinzza5: calls $066
*** FLOP *** [Th 9d 2c]
sinzza5: checks
Lorpugo: checks
*** TURN *** [Th 9d 2c] [6d]
sinzza5: checks
Lorpugo: checks
*** RIVER *** [Th 9d 2c 6d] [8d]
sinzza5: bets $220
Lorpugo: folds
Uncalled bet ($220) returned to sinzza5
sinzza5 collected $220 from pot
sinzza5: doesn't show hand
*** SUMMARY ***
Total pot $232 | Rake $012
Board [Th 9d 2c 6d 8d]
Seat 1: Lorpugo (button) (small blind) folded on the River
Seat 2: sinzza5 (big blind) collected ($220)


*********** # 179 **************
PokerStars Zoom Hand #235731733324: Hold'em No Limit ($025/$050) - 2022/04/25 16:05:32 ET
Table 'C Carinae' 2-max Seat #1 is the button
Seat 1: Lorpugo ($2432 in chips)
Seat 2: lilyjackvs1 ($50 in chips)
Lorpugo: posts small blind $025
lilyjackvs1: posts big blind $050
*** HOLE CARDS ***
Dealt to Lorpugo [Js 5s]
Lorpugo: raises $060 to $110
lilyjackvs1: folds
Uncalled bet ($060) returned to Lorpugo
Lorpugo collected $1 from pot
Lorpugo: doesn't show hand
*** SUMMARY ***
Total pot $1 | Rake $0
Seat 1: Lorpugo (button) (small blind) collected ($1)
Seat 2: lilyjackvs1 (big blind) folded before Flop


*********** # 180 **************
PokerStars Zoom Hand #235731727303: Hold'em No Limit ($025/$050) - 2022/04/25 16:05:18 ET
Table 'C Carinae' 2-max Seat #1 is the button
Seat 1: Lorpugo ($2382 in chips)
Seat 2: ZenMisery ($5063 in chips)
Lorpugo: posts small blind $025
ZenMisery: posts big blind $050
*** HOLE CARDS ***
Dealt to Lorpugo [Qh Th]
Lorpugo: raises $075 to $125
ZenMisery: folds
Uncalled bet ($075) returned to Lorpugo
Lorpugo collected $1 from pot
Lorpugo: doesn't show hand
*** SUMMARY ***
Total pot $1 | Rake $0
Seat 1: Lorpugo (button) (small blind) collected ($1)
Seat 2: ZenMisery (big blind) folded before Flop


*********** # 181 **************
PokerStars Zoom Hand #235731723463: Hold'em No Limit ($025/$050) - 2022/04/25 16:05:09 ET
Table 'C Carinae' 2-max Seat #1 is the button
Seat 1: Lorpugo ($2332 in chips)
Seat 2: OverCologne ($9304 in chips)
Lorpugo: posts small blind $025
OverCologne: posts big blind $050
*** HOLE CARDS ***
Dealt to Lorpugo [2d 9d]
Lorpugo: raises $075 to $125
OverCologne: folds
Uncalled bet ($075) returned to Lorpugo
Lorpugo collected $1 from pot
Lorpugo: doesn't show hand
*** SUMMARY ***
Total pot $1 | Rake $0
Seat 1: Lorpugo (button) (small blind) collected ($1)
Seat 2: OverCologne (big blind) folded before Flop


*********** # 182 **************
PokerStars Zoom Hand #235731710364: Hold'em No Limit ($025/$050) - 2022/04/25 16:04:39 ET
Table 'C Carinae' 2-max Seat #1 is the button
Seat 1: min_ace ($3247 in chips)
Seat 2: Lorpugo ($2024 in chips)
min_ace: posts small blind $025
Lorpugo: posts big blind $050
*** HOLE CARDS ***
Dealt to Lorpugo [9h 5h]
min_ace: raises $1 to $150
Lorpugo: calls $1
*** FLOP *** [7s 4d 8s]
Lorpugo: checks
min_ace: bets $192
Lorpugo: calls $192
*** TURN *** [7s 4d 8s] [Js]
Lorpugo: checks
min_ace: checks
*** RIVER *** [7s 4d 8s Js] [Td]
Lorpugo: bets $350
min_ace: folds
Uncalled bet ($350) returned to Lorpugo
Lorpugo collected $650 from pot
Lorpugo: doesn't show hand
min_ace is disconnected
*** SUMMARY ***
Total pot $684 | Rake $034
Board [7s 4d 8s Js Td]
Seat 1: min_ace (button) (small blind) folded on the River
Seat 2: Lorpugo (big blind) collected ($650)


*********** # 183 **************
PokerStars Zoom Hand #235731707912: Hold'em No Limit ($025/$050) - 2022/04/25 16:04:33 ET
Table 'C Carinae' 2-max Seat #1 is the button
Seat 1: min_ace ($3272 in chips)
Seat 2: Lorpugo ($1999 in chips)
min_ace: posts small blind $025
Lorpugo: posts big blind $050
*** HOLE CARDS ***
Dealt to Lorpugo [2h 8c]
min_ace: folds
Uncalled bet ($025) returned to Lorpugo
Lorpugo collected $050 from pot
Lorpugo: doesn't show hand
min_ace is disconnected
*** SUMMARY ***
Total pot $050 | Rake $0
Seat 1: min_ace (button) (small blind) folded before Flop
Seat 2: Lorpugo (big blind) collected ($050)


*********** # 184 **************
PokerStars Zoom Hand #235731704850: Hold'em No Limit ($025/$050) - 2022/04/25 16:04:26 ET
Table 'C Carinae' 2-max Seat #1 is the button
Seat 1: Lorpugo ($1949 in chips)
Seat 2: FradiMob ($50 in chips)
Lorpugo: posts small blind $025
FradiMob: posts big blind $050
*** HOLE CARDS ***
Dealt to Lorpugo [9h 6s]
Lorpugo: raises $050 to $1
FradiMob: folds
Uncalled bet ($050) returned to Lorpugo
Lorpugo collected $1 from pot
Lorpugo: doesn't show hand
*** SUMMARY ***
Total pot $1 | Rake $0
Seat 1: Lorpugo (button) (small blind) collected ($1)
Seat 2: FradiMob (big blind) folded before Flop


*********** # 185 **************
PokerStars Zoom Hand #235731697310: Hold'em No Limit ($025/$050) - 2022/04/25 16:04:08 ET
Table 'C Carinae' 2-max Seat #1 is the button
Seat 1: ZenMisery ($5025 in chips)
Seat 2: Lorpugo ($1824 in chips)
ZenMisery: posts small blind $025
Lorpugo: posts big blind $050
*** HOLE CARDS ***
Dealt to Lorpugo [Ah Js]
ZenMisery: raises $075 to $125
Lorpugo: raises $1699 to $1824 and is all-in
ZenMisery: folds
Uncalled bet ($1699) returned to Lorpugo
Lorpugo collected $250 from pot
Lorpugo: doesn't show hand
*** SUMMARY ***
Total pot $250 | Rake $0
Seat 1: ZenMisery (button) (small blind) folded before Flop
Seat 2: Lorpugo (big blind) collected ($250)


*********** # 186 **************
PokerStars Zoom Hand #235731693047: Hold'em No Limit ($025/$050) - 2022/04/25 16:03:58 ET
Table 'C Carinae' 2-max Seat #1 is the button
Seat 1: Lorpugo ($1849 in chips)
Seat 2: ZenMisery ($50 in chips)
Lorpugo: posts small blind $025
ZenMisery: posts big blind $050
*** HOLE CARDS ***
Dealt to Lorpugo [9c 4h]
Lorpugo: folds
Uncalled bet ($025) returned to ZenMisery
ZenMisery collected $050 from pot
ZenMisery: doesn't show hand
*** SUMMARY ***
Total pot $050 | Rake $0
Seat 1: Lorpugo (button) (small blind) folded before Flop
Seat 2: ZenMisery (big blind) collected ($050)


*********** # 187 **************
PokerStars Zoom Hand #235731686536: Hold'em No Limit ($025/$050) - 2022/04/25 16:03:43 ET
Table 'C Carinae' 2-max Seat #1 is the button
Seat 1: zukmens ($2525 in chips)
Seat 2: Lorpugo ($1899 in chips)
zukmens: posts small blind $025
Lorpugo: posts big blind $050
*** HOLE CARDS ***
Dealt to Lorpugo [4d Jh]
zukmens: raises $1 to $150
Lorpugo: folds
Uncalled bet ($1) returned to zukmens
zukmens collected $1 from pot
zukmens: doesn't show hand
*** SUMMARY ***
Total pot $1 | Rake $0
Seat 1: zukmens (button) (small blind) collected ($1)
Seat 2: Lorpugo (big blind) folded before Flop


*********** # 188 **************
PokerStars Zoom Hand #235731677904: Hold'em No Limit ($025/$050) - 2022/04/25 16:03:23 ET
Table 'C Carinae' 2-max Seat #1 is the button
Seat 1: Lorpugo ($1809 in chips)
Seat 2: OverCologne ($6916 in chips)
Lorpugo: posts small blind $025
OverCologne: posts big blind $050
*** HOLE CARDS ***
Dealt to Lorpugo [6s 6c]
Lorpugo: raises $050 to $1
OverCologne: calls $050
*** FLOP *** [7h 3h As]
OverCologne: checks
Lorpugo: bets $063
OverCologne: folds
Uncalled bet ($063) returned to Lorpugo
Lorpugo collected $190 from pot
Lorpugo: doesn't show hand
*** SUMMARY ***
Total pot $2 | Rake $010
Board [7h 3h As]
Seat 1: Lorpugo (button) (small blind) collected ($190)
Seat 2: OverCologne (big blind) folded on the Flop


*********** # 189 **************
PokerStars Zoom Hand #235731671901: Hold'em No Limit ($025/$050) - 2022/04/25 16:03:09 ET
Table 'C Carinae' 2-max Seat #1 is the button
Seat 1: OverCologne ($8419 in chips)
Seat 2: Lorpugo ($1859 in chips)
OverCologne: posts small blind $025
Lorpugo: posts big blind $050
*** HOLE CARDS ***
Dealt to Lorpugo [Qh 3d]
OverCologne: raises $075 to $125
Lorpugo: folds
Uncalled bet ($075) returned to OverCologne
OverCologne collected $1 from pot
OverCologne: doesn't show hand
*** SUMMARY ***
Total pot $1 | Rake $0
Seat 1: OverCologne (button) (small blind) collected ($1)
Seat 2: Lorpugo (big blind) folded before Flop


*********** # 190 **************
PokerStars Zoom Hand #235731666939: Hold'em No Limit ($025/$050) - 2022/04/25 16:02:57 ET
Table 'C Carinae' 2-max Seat #1 is the button
Seat 1: Lorpugo ($1959 in chips)
Seat 2: OverCologne ($8319 in chips)
Lorpugo: posts small blind $025
OverCologne: posts big blind $050
*** HOLE CARDS ***
Dealt to Lorpugo [9s 4s]
Lorpugo: raises $050 to $1
OverCologne: raises $3 to $4
Lorpugo: folds
Uncalled bet ($3) returned to OverCologne
OverCologne collected $2 from pot
OverCologne: doesn't show hand
*** SUMMARY ***
Total pot $2 | Rake $0
Seat 1: Lorpugo (button) (small blind) folded before Flop
Seat 2: OverCologne (big blind) collected ($2)


*********** # 191 **************
PokerStars Zoom Hand #235731646125: Hold'em No Limit ($025/$050) - 2022/04/25 16:02:07 ET
Table 'C Carinae' 2-max Seat #1 is the button
Seat 1: OverCologne ($8116 in chips)
Seat 2: Lorpugo ($2184 in chips)
OverCologne: posts small blind $025
Lorpugo: posts big blind $050
*** HOLE CARDS ***
Dealt to Lorpugo [6s 7d]
OverCologne: raises $075 to $125
Lorpugo: calls $075
*** FLOP *** [Ts 7h 9d]
Lorpugo: bets $050
OverCologne: raises $050 to $1
Lorpugo: calls $050
*** TURN *** [Ts 7h 9d] [Qc]
Lorpugo: checks
OverCologne: checks
*** RIVER *** [Ts 7h 9d Qc] [3d]
Lorpugo: checks
OverCologne: bets $125
Lorpugo: folds
Uncalled bet ($125) returned to OverCologne
OverCologne collected $428 from pot
OverCologne: doesn't show hand
*** SUMMARY ***
Total pot $450 | Rake $022
Board [Ts 7h 9d Qc 3d]
Seat 1: OverCologne (button) (small blind) collected ($428)
Seat 2: Lorpugo (big blind) folded on the River


*********** # 192 **************
PokerStars Zoom Hand #235731613230: Hold'em No Limit ($025/$050) - 2022/04/25 16:00:42 ET
Table 'C Carinae' 2-max Seat #1 is the button
Seat 1: Lorpugo ($2774 in chips)
Seat 2: lucaslucas7 ($6612 in chips)
Lorpugo: posts small blind $025
lucaslucas7: posts big blind $050
*** HOLE CARDS ***
Dealt to Lorpugo [Jd 8c]
Lorpugo: raises $060 to $110
lucaslucas7: calls $060
*** FLOP *** [Qc 4h 9c]
lucaslucas7: checks
Lorpugo: bets $065
lucaslucas7: calls $065
*** TURN *** [Qc 4h 9c] [7h]
lucaslucas7: checks
Lorpugo: bets $1
lucaslucas7: calls $1
*** RIVER *** [Qc 4h 9c 7h] [Kh]
lucaslucas7: checks
Lorpugo: bets $315
lucaslucas7: calls $315
*** SHOW DOWN ***
Lorpugo: shows [Jd 8c] (high card King)
lucaslucas7: shows [8d Qd] (a pair of Queens)
lucaslucas7 collected $1121 from pot
*** SUMMARY ***
Total pot $1180 | Rake $059
Board [Qc 4h 9c 7h Kh]
Seat 1: Lorpugo (button) (small blind) showed [Jd 8c] and lost with high card King
Seat 2: lucaslucas7 (big blind) showed [8d Qd] and won ($1121) with a pair of Queens


*********** # 193 **************
PokerStars Zoom Hand #235731594267: Hold'em No Limit ($025/$050) - 2022/04/25 16:00:02 ET
Table 'C Carinae' 2-max Seat #1 is the button
Seat 1: Lorpugo ($2879 in chips)
Seat 2: Dougpolk27997 ($50 in chips)
Lorpugo: posts small blind $025
Dougpolk27997: posts big blind $050
*** HOLE CARDS ***
Dealt to Lorpugo [4h 4c]
Lorpugo: raises $055 to $105
Dougpolk27997: calls $055
*** FLOP *** [Qh Th 6c]
Dougpolk27997: checks
Lorpugo: checks
*** TURN *** [Qh Th 6c] [3s]
Dougpolk27997: bets $132
Lorpugo: folds
Uncalled bet ($132) returned to Dougpolk27997
Dougpolk27997 collected $2 from pot
Dougpolk27997: doesn't show hand
*** SUMMARY ***
Total pot $210 | Rake $010
Board [Qh Th 6c 3s]
Seat 1: Lorpugo (button) (small blind) folded on the Turn
Seat 2: Dougpolk27997 (big blind) collected ($2)


*********** # 194 **************
PokerStars Zoom Hand #235731591012: Hold'em No Limit ($025/$050) - 2022/04/25 15:59:52 ET
Table 'C Carinae' 2-max Seat #1 is the button
Seat 1: min_ace ($3467 in chips)
Seat 2: Lorpugo ($2854 in chips)
min_ace: posts small blind $025
Lorpugo: posts big blind $050
*** HOLE CARDS ***
Dealt to Lorpugo [2d 4h]
min_ace: folds
Uncalled bet ($025) returned to Lorpugo
Lorpugo collected $050 from pot
Lorpugo: doesn't show hand
min_ace is disconnected
*** SUMMARY ***
Total pot $050 | Rake $0
Seat 1: min_ace (button) (small blind) folded before Flop
Seat 2: Lorpugo (big blind) collected ($050)


*********** # 195 **************
PokerStars Zoom Hand #235731574744: Hold'em No Limit ($025/$050) - 2022/04/25 15:59:01 ET
Table 'C Carinae' 2-max Seat #1 is the button
Seat 1: sinzza5 ($5624 in chips)
Seat 2: Lorpugo ($2634 in chips)
sinzza5: posts small blind $025
Lorpugo: posts big blind $050
*** HOLE CARDS ***
Dealt to Lorpugo [Ah Ad]
sinzza5: calls $025
Lorpugo: raises $1 to $150
sinzza5: calls $1
*** FLOP *** [4s 2d Kd]
Lorpugo: bets $094
sinzza5: calls $094
*** TURN *** [4s 2d Kd] [Ac]
Lorpugo: bets $2
sinzza5: folds
Uncalled bet ($2) returned to Lorpugo
Lorpugo collected $464 from pot
Lorpugo: doesn't show hand
sinzza5 is disconnected
*** SUMMARY ***
Total pot $488 | Rake $024
Board [4s 2d Kd Ac]
Seat 1: sinzza5 (button) (small blind) folded on the Turn
Seat 2: Lorpugo (big blind) collected ($464)


*********** # 196 **************
PokerStars Zoom Hand #235731562989: Hold'em No Limit ($025/$050) - 2022/04/25 15:58:24 ET
Table 'C Carinae' 2-max Seat #1 is the button
Seat 1: Lorpugo ($2739 in chips)
Seat 2: sinzza5 ($5529 in chips)
Lorpugo: posts small blind $025
sinzza5: posts big blind $050
*** HOLE CARDS ***
Dealt to Lorpugo [3s Qh]
Lorpugo: raises $055 to $105
sinzza5: calls $055
*** FLOP *** [9h Kh Ks]
sinzza5: checks
Lorpugo: checks
*** TURN *** [9h Kh Ks] [5c]
sinzza5: bets $2
Lorpugo: folds
Uncalled bet ($2) returned to sinzza5
sinzza5 collected $2 from pot
sinzza5: doesn't show hand
*** SUMMARY ***
Total pot $210 | Rake $010
Board [9h Kh Ks 5c]
Seat 1: Lorpugo (button) (small blind) folded on the Turn
Seat 2: sinzza5 (big blind) collected ($2)


*********** # 197 **************
PokerStars Zoom Hand #235731543456: Hold'em No Limit ($025/$050) - 2022/04/25 15:57:21 ET
Table 'C Carinae' 2-max Seat #1 is the button
Seat 1: OverCologne ($5467 in chips)
Seat 2: Lorpugo ($2550 in chips)
OverCologne: posts small blind $025
Lorpugo: posts big blind $050
*** HOLE CARDS ***
Dealt to Lorpugo [8c 6h]
OverCologne: raises $075 to $125
Lorpugo: calls $075
*** FLOP *** [Tc 6s 5h]
Lorpugo: checks
OverCologne: checks
*** TURN *** [Tc 6s 5h] [6d]
Lorpugo: bets $085
OverCologne: calls $085
*** RIVER *** [Tc 6s 5h 6d] [Kd]
Lorpugo: bets $399
OverCologne: folds
Uncalled bet ($399) returned to Lorpugo
Lorpugo collected $399 from pot
Lorpugo: doesn't show hand
*** SUMMARY ***
Total pot $420 | Rake $021
Board [Tc 6s 5h 6d Kd]
Seat 1: OverCologne (button) (small blind) folded on the River
Seat 2: Lorpugo (big blind) collected ($399)


*********** # 198 **************
PokerStars Zoom Hand #235731540674: Hold'em No Limit ($025/$050) - 2022/04/25 15:57:12 ET
Table 'C Carinae' 2-max Seat #1 is the button
Seat 1: Lorpugo ($25 in chips)
Seat 2: Namlessss ($4925 in chips)
Lorpugo: posts small blind $025
Namlessss: posts big blind $050
*** HOLE CARDS ***
Dealt to Lorpugo [Qs 5h]
Lorpugo: raises $050 to $1
Namlessss: folds
Uncalled bet ($050) returned to Lorpugo
Lorpugo collected $1 from pot
Lorpugo: doesn't show hand
Namlessss is disconnected
*** SUMMARY ***
Total pot $1 | Rake $0
Seat 1: Lorpugo (button) (small blind) collected ($1)
Seat 2: Namlessss (big blind) folded before Flop


*********** # 199 **************
PokerStars Zoom Hand #235731538398: Hold'em No Limit ($025/$050) - 2022/04/25 15:57:05 ET
Table 'C Carinae' 2-max Seat #1 is the button
Seat 1: Namlessss ($4950 in chips)
Seat 2: Lorpugo ($2475 in chips)
Namlessss: posts small blind $025
Lorpugo: posts big blind $050
*** HOLE CARDS ***
Dealt to Lorpugo [7h 4d]
Namlessss: folds
Uncalled bet ($025) returned to Lorpugo
Lorpugo collected $050 from pot
Lorpugo: doesn't show hand
Namlessss is disconnected
*** SUMMARY ***
Total pot $050 | Rake $0
Seat 1: Namlessss (button) (small blind) folded before Flop
Seat 2: Lorpugo (big blind) collected ($050)


*********** # 200 **************
PokerStars Zoom Hand #235731535039: Hold'em No Limit ($025/$050) - 2022/04/25 15:56:54 ET
Table 'C Carinae' 2-max Seat #1 is the button
Seat 1: Lorpugo ($2425 in chips)
Seat 2: Namlessss ($50 in chips)
Lorpugo: posts small blind $025
Namlessss: posts big blind $050
*** HOLE CARDS ***
Dealt to Lorpugo [3h 2h]
Lorpugo: raises $050 to $1
Namlessss: folds
Uncalled bet ($050) returned to Lorpugo
Lorpugo collected $1 from pot
Lorpugo: doesn't show hand
Namlessss is disconnected
*** SUMMARY ***
Total pot $1 | Rake $0
Seat 1: Lorpugo (button) (small blind) collected ($1)
Seat 2: Namlessss (big blind) folded before Flop