*********** # 74 **************
PokerStars Zoom Hand #236068014929: Hold'em No Limit ($025/$050) - 2022/05/11 19:15:49 ET
Table 'C Carinae' 2-max Seat #1 is the button
Seat 1: Nbg453 ($15618 in chips)
Seat 2: Lorpugo ($2598 in chips)
Nbg453: posts small blind $025
Lorpugo: posts big blind $050
*** HOLE CARDS ***
Dealt to Lorpugo [Ac Qd]
Nbg453: raises $1 to $150
Lorpugo: raises $350 to $5
Nbg453: calls $350
*** FLOP *** [3s Qh Ks]
Lorpugo: checks
Nbg453: bets $475
Lorpugo: raises $1623 to $2098 and is all-in
Nbg453: calls $1623
*** TURN *** [3s Qh Ks] [8h]
Lorpugo: prays
*** RIVER *** [3s Qh Ks 8h] [Th]
Lorpugo: prays
*** SHOW DOWN ***
Lorpugo: shows [Ac Qd] (a pair of Queens)
Nbg453: shows [Kd 6h] (a pair of Kings)
Nbg453 cashed out the hand for $3963 | Cash Out Fee $040
*** SUMMARY ***
Total pot $5196 | Rake $075
Board [3s Qh Ks 8h Th]
Seat 1: Nbg453 (button) (small blind) showed [Kd 6h] and won ($5121) with a pair of Kings (pot not awarded as player cashed out)
Seat 2: Lorpugo (big blind) showed [Ac Qd] and lost with a pair of Queens

*********** # 75 **************
PokerStars Zoom Hand #236068002936: Hold'em No Limit ($025/$050) - 2022/05/11 19:15:07 ET
Table 'C Carinae' 2-max Seat #1 is the button
Seat 1: Lorpugo ($2485 in chips)
Seat 2: DzemAs ($4960 in chips)
Lorpugo: posts small blind $025
DzemAs: posts big blind $050
*** HOLE CARDS ***
Dealt to Lorpugo [Qs 4s]
Lorpugo: raises $075 to $125
DzemAs: calls $075
*** FLOP *** [Qc 4h 9s]
DzemAs: checks
Lorpugo: checks
*** TURN *** [Qc 4h 9s] [7d]
DzemAs: checks
Lorpugo: bets $119
DzemAs: folds
Uncalled bet ($119) returned to Lorpugo
Lorpugo collected $238 from pot
Lorpugo: doesn't show hand
*** SUMMARY ***
Total pot $250 | Rake $012
Board [Qc 4h 9s 7d]
Seat 1: Lorpugo (button) (small blind) collected ($238)
Seat 2: DzemAs (big blind) folded on the Turn

*********** # 76 **************
PokerStars Zoom Hand #236067998651: Hold'em No Limit ($025/$050) - 2022/05/11 19:14:52 ET
Table 'C Carinae' 2-max Seat #1 is the button
Seat 1: DzemAs ($4910 in chips)
Seat 2: Lorpugo ($2535 in chips)
DzemAs: posts small blind $025
Lorpugo: posts big blind $050
*** HOLE CARDS ***
Dealt to Lorpugo [2h Td]
DzemAs: raises $065 to $115
Lorpugo: folds
Uncalled bet ($065) returned to DzemAs
DzemAs collected $1 from pot
DzemAs: doesn't show hand
*** SUMMARY ***
Total pot $1 | Rake $0
Seat 1: DzemAs (button) (small blind) collected ($1)
Seat 2: Lorpugo (big blind) folded before Flop

*********** # 77 **************
PokerStars Zoom Hand #236067986190: Hold'em No Limit ($025/$050) - 2022/05/11 19:14:08 ET
Table 'C Carinae' 2-max Seat #1 is the button
Seat 1: Sir Lehmi ($9454 in chips)
Seat 2: Lorpugo ($2445 in chips)
Sir Lehmi: posts small blind $025
Lorpugo: posts big blind $050
*** HOLE CARDS ***
Dealt to Lorpugo [2s 4s]
Sir Lehmi: raises $050 to $1
Lorpugo: calls $050
*** FLOP *** [As Qc Qs]
Lorpugo: checks
Sir Lehmi: checks
*** TURN *** [As Qc Qs] [8c]
Lorpugo: bets $095
Sir Lehmi: folds
Uncalled bet ($095) returned to Lorpugo
Lorpugo collected $190 from pot
Lorpugo: doesn't show hand
Sir Lehmi is disconnected
*** SUMMARY ***
Total pot $2 | Rake $010
Board [As Qc Qs 8c]
Seat 1: Sir Lehmi (button) (small blind) folded on the Turn
Seat 2: Lorpugo (big blind) collected ($190)

*********** # 78 **************
PokerStars Zoom Hand #236067982475: Hold'em No Limit ($025/$050) - 2022/05/11 19:13:55 ET
Table 'C Carinae' 2-max Seat #1 is the button
Seat 1: Lorpugo ($2395 in chips)
Seat 2: marco693230 ($5020 in chips)
Lorpugo: posts small blind $025
marco693230: posts big blind $050
*** HOLE CARDS ***
Dealt to Lorpugo [Ks 9h]
Lorpugo: raises $075 to $125
marco693230: folds
Uncalled bet ($075) returned to Lorpugo
Lorpugo collected $1 from pot
Lorpugo: doesn't show hand
*** SUMMARY ***
Total pot $1 | Rake $0
Seat 1: Lorpugo (button) (small blind) collected ($1)
Seat 2: marco693230 (big blind) folded before Flop

*********** # 79 **************
PokerStars Zoom Hand #236067976355: Hold'em No Limit ($025/$050) - 2022/05/11 19:13:34 ET
Table 'C Carinae' 2-max Seat #1 is the button
Seat 1: Lorpugo ($2305 in chips)
Seat 2: RemCavemin ($5594 in chips)
Lorpugo: posts small blind $025
RemCavemin: posts big blind $050
*** HOLE CARDS ***
Dealt to Lorpugo [Jc Jd]
Lorpugo: raises $050 to $1
RemCavemin: calls $050
*** FLOP *** [2d 3d 9d]
RemCavemin: checks
Lorpugo: bets $063
RemCavemin: folds
Uncalled bet ($063) returned to Lorpugo
Lorpugo collected $190 from pot
Lorpugo: doesn't show hand
*** SUMMARY ***
Total pot $2 | Rake $010
Board [2d 3d 9d]
Seat 1: Lorpugo (button) (small blind) collected ($190)
Seat 2: RemCavemin (big blind) folded on the Flop

*********** # 80 **************
PokerStars Zoom Hand #236067968811: Hold'em No Limit ($025/$050) - 2022/05/11 19:13:08 ET
Table 'C Carinae' 2-max Seat #1 is the button
Seat 1: KrisMcC81 ($25176 in chips)
Seat 2: Lorpugo ($1997 in chips)
KrisMcC81: posts small blind $025
Lorpugo: posts big blind $050
*** HOLE CARDS ***
Dealt to Lorpugo [5h 6c]
KrisMcC81: raises $1 to $150
Lorpugo: calls $1
*** FLOP *** [2h 3s Tc]
Lorpugo: checks
KrisMcC81: bets $192
Lorpugo: calls $192
*** TURN *** [2h 3s Tc] [Ad]
Lorpugo: checks
KrisMcC81: checks
*** RIVER *** [2h 3s Tc Ad] [7s]
Lorpugo: bets $650
KrisMcC81: folds
Uncalled bet ($650) returned to Lorpugo
Lorpugo collected $650 from pot
Lorpugo: doesn't show hand
KrisMcC81 is disconnected
*** SUMMARY ***
Total pot $684 | Rake $034
Board [2h 3s Tc Ad 7s]
Seat 1: KrisMcC81 (button) (small blind) folded on the River
Seat 2: Lorpugo (big blind) collected ($650)

*********** # 81 **************
PokerStars Zoom Hand #236067961361: Hold'em No Limit ($025/$050) - 2022/05/11 19:12:42 ET
Table 'C Carinae' 2-max Seat #1 is the button
Seat 1: Mich4elN ($30152 in chips)
Seat 2: Lorpugo ($2577 in chips)
Mich4elN: posts small blind $025
Lorpugo: posts big blind $050
*** HOLE CARDS ***
Dealt to Lorpugo [Qd 5c]
Mich4elN: calls $025
Lorpugo: checks
*** FLOP *** [9s 3d 2c]
Lorpugo: checks
Mich4elN: bets $050
Lorpugo: calls $050
*** TURN *** [9s 3d 2c] [Qs]
Lorpugo: checks
Mich4elN: bets $1
Lorpugo: calls $1
*** RIVER *** [9s 3d 2c Qs] [Ah]
Lorpugo: checks
Mich4elN: bets $380
Lorpugo: calls $380
*** SHOW DOWN ***
Mich4elN: shows [As Ac] (three of a kind, Aces)
Lorpugo: mucks hand
Mich4elN collected $1102 from pot
*** SUMMARY ***
Total pot $1160 | Rake $058
Board [9s 3d 2c Qs Ah]
Seat 1: Mich4elN (button) (small blind) showed [As Ac] and won ($1102) with three of a kind, Aces
Seat 2: Lorpugo (big blind) mucked [Qd 5c]

*********** # 82 **************
PokerStars Zoom Hand #236067959107: Hold'em No Limit ($025/$050) - 2022/05/11 19:12:34 ET
Table 'C Carinae' 2-max Seat #1 is the button
Seat 1: Lorpugo ($2602 in chips)
Seat 2: marco693230 ($5032 in chips)
Lorpugo: posts small blind $025
marco693230: posts big blind $050
*** HOLE CARDS ***
Dealt to Lorpugo [Qs 3d]
Lorpugo: folds
Uncalled bet ($025) returned to marco693230
marco693230 collected $050 from pot
marco693230: doesn't show hand
*** SUMMARY ***
Total pot $050 | Rake $0
Seat 1: Lorpugo (button) (small blind) folded before Flop
Seat 2: marco693230 (big blind) collected ($050)

*********** # 83 **************
PokerStars Zoom Hand #236067956754: Hold'em No Limit ($025/$050) - 2022/05/11 19:12:26 ET
Table 'C Carinae' 2-max Seat #1 is the button
Seat 1: marcmm36 ($2424 in chips)
Seat 2: Lorpugo ($2577 in chips)
marcmm36: posts small blind $025
Lorpugo: posts big blind $050
*** HOLE CARDS ***
Dealt to Lorpugo [Ac As]
marcmm36: folds
Uncalled bet ($025) returned to Lorpugo
Lorpugo collected $050 from pot
Lorpugo: doesn't show hand
*** SUMMARY ***
Total pot $050 | Rake $0
Seat 1: marcmm36 (button) (small blind) folded before Flop
Seat 2: Lorpugo (big blind) collected ($050)

*********** # 84 **************
PokerStars Zoom Hand #236067955246: Hold'em No Limit ($025/$050) - 2022/05/11 19:12:21 ET
Table 'C Carinae' 2-max Seat #1 is the button
Seat 1: Lorpugo ($2602 in chips)
Seat 2: 2outsdamn ($2676 in chips)
Lorpugo: posts small blind $025
2outsdamn: posts big blind $050
*** HOLE CARDS ***
Dealt to Lorpugo [6s 2h]
Lorpugo: folds
Uncalled bet ($025) returned to 2outsdamn
2outsdamn collected $050 from pot
2outsdamn: doesn't show hand
*** SUMMARY ***
Total pot $050 | Rake $0
Seat 1: Lorpugo (button) (small blind) folded before Flop
Seat 2: 2outsdamn (big blind) collected ($050)

*********** # 85 **************
PokerStars Zoom Hand #236067951467: Hold'em No Limit ($025/$050) - 2022/05/11 19:12:08 ET
Table 'C Carinae' 2-max Seat #1 is the button
Seat 1: Lorpugo ($2727 in chips)
Seat 2: XBR93 ($6666 in chips)
Lorpugo: posts small blind $025
XBR93: posts big blind $050
*** HOLE CARDS ***
Dealt to Lorpugo [Ks Jc]
Lorpugo: raises $075 to $125
XBR93: calls $075
*** FLOP *** [6d 4d Td]
XBR93: bets $2
Lorpugo: folds
Uncalled bet ($2) returned to XBR93
XBR93 collected $238 from pot
XBR93: doesn't show hand
*** SUMMARY ***
Total pot $250 | Rake $012
Board [6d 4d Td]
Seat 1: Lorpugo (button) (small blind) folded on the Flop
Seat 2: XBR93 (big blind) collected ($238)

*********** # 86 **************
PokerStars Zoom Hand #236067949388: Hold'em No Limit ($025/$050) - 2022/05/11 19:12:01 ET
Table 'C Carinae' 2-max Seat #1 is the button
Seat 1: Lorpugo ($2677 in chips)
Seat 2: Kodeldowski ($5348 in chips)
Lorpugo: posts small blind $025
Kodeldowski: posts big blind $050
*** HOLE CARDS ***
Dealt to Lorpugo [Tc 6c]
Lorpugo: raises $075 to $125
Kodeldowski: folds
Uncalled bet ($075) returned to Lorpugo
Lorpugo collected $1 from pot
Lorpugo: doesn't show hand
*** SUMMARY ***
Total pot $1 | Rake $0
Seat 1: Lorpugo (button) (small blind) collected ($1)
Seat 2: Kodeldowski (big blind) folded before Flop


*********** # 87 **************
PokerStars Zoom Hand #236067943881: Hold'em No Limit ($025/$050) - 2022/05/11 19:11:42 ET
Table 'C Carinae' 2-max Seat #1 is the button
Seat 1: marcmm36 ($2209 in chips)
Seat 2: Lorpugo ($2777 in chips)
marcmm36: posts small blind $025
Lorpugo: posts big blind $050
*** HOLE CARDS ***
Dealt to Lorpugo [7s Qc]
marcmm36: calls $025
Lorpugo: checks
*** FLOP *** [9c 7d Tc]
Lorpugo: checks
marcmm36: bets $050
Lorpugo: calls $050
*** TURN *** [9c 7d Tc] [6h]
Lorpugo: checks
marcmm36: bets $190
Lorpugo: folds
Uncalled bet ($190) returned to marcmm36
marcmm36 collected $190 from pot
marcmm36: doesn't show hand
*** SUMMARY ***
Total pot $2 | Rake $010
Board [9c 7d Tc 6h]
Seat 1: marcmm36 (button) (small blind) collected ($190)
Seat 2: Lorpugo (big blind) folded on the Turn


*********** # 88 **************
PokerStars Zoom Hand #236067936904: Hold'em No Limit ($025/$050) - 2022/05/11 19:11:18 ET
Table 'C Carinae' 2-max Seat #1 is the button
Seat 1: ZenMisery ($50 in chips)
Seat 2: Lorpugo ($2530 in chips)
ZenMisery: posts small blind $025
Lorpugo: posts big blind $050
*** HOLE CARDS ***
Dealt to Lorpugo [9h Ks]
ZenMisery: raises $075 to $125
Lorpugo: calls $075
*** FLOP *** [7c 4d 7s]
Lorpugo: checks
ZenMisery: checks
*** TURN *** [7c 4d 7s] [Jd]
Lorpugo: checks
ZenMisery: bets $150
Lorpugo: raises $269 to $419
ZenMisery: folds
Uncalled bet ($269) returned to Lorpugo
Lorpugo collected $522 from pot
Lorpugo: doesn't show hand
*** SUMMARY ***
Total pot $550 | Rake $028
Board [7c 4d 7s Jd]
Seat 1: ZenMisery (button) (small blind) folded on the Turn
Seat 2: Lorpugo (big blind) collected ($522)


*********** # 89 **************
PokerStars Zoom Hand #236067932243: Hold'em No Limit ($025/$050) - 2022/05/11 19:11:02 ET
Table 'C Carinae' 2-max Seat #1 is the button
Seat 1: Lorpugo ($2205 in chips)
Seat 2: ZenMisery ($5230 in chips)
Lorpugo: posts small blind $025
ZenMisery: posts big blind $050
*** HOLE CARDS ***
Dealt to Lorpugo [Kh Ac]
Lorpugo: raises $050 to $1
ZenMisery: raises $225 to $325
Lorpugo: raises $1880 to $2205 and is all-in
ZenMisery: folds
Uncalled bet ($1880) returned to Lorpugo
Lorpugo collected $650 from pot
Lorpugo: doesn't show hand
*** SUMMARY ***
Total pot $650 | Rake $0
Seat 1: Lorpugo (button) (small blind) collected ($650)
Seat 2: ZenMisery (big blind) folded before Flop


*********** # 90 **************
PokerStars Zoom Hand #236067928653: Hold'em No Limit ($025/$050) - 2022/05/11 19:10:49 ET
Table 'C Carinae' 2-max Seat #1 is the button
Seat 1: Kodeldowski ($5338 in chips)
Seat 2: Lorpugo ($2330 in chips)
Kodeldowski: posts small blind $025
Lorpugo: posts big blind $050
*** HOLE CARDS ***
Dealt to Lorpugo [Jh 8d]
Kodeldowski: raises $075 to $125
Lorpugo: calls $075
*** FLOP *** [7s 9s Qs]
Lorpugo: checks
Kodeldowski: bets $125
Lorpugo: folds
Uncalled bet ($125) returned to Kodeldowski
Kodeldowski collected $235 from pot
Kodeldowski: doesn't show hand
*** SUMMARY ***
Total pot $250 | Rake $015
Board [7s 9s Qs]
Seat 1: Kodeldowski (button) (small blind) collected ($235)
Seat 2: Lorpugo (big blind) folded on the Flop


*********** # 91 **************
PokerStars Zoom Hand #236067927242: Hold'em No Limit ($025/$050) - 2022/05/11 19:10:44 ET
Table 'C Carinae' 2-max Seat #1 is the button
Seat 1: Lorpugo ($2355 in chips)
Seat 2: [chr1StaR] ($5075 in chips)
Lorpugo: posts small blind $025
[chr1StaR]: posts big blind $050
*** HOLE CARDS ***
Dealt to Lorpugo [Qs 2c]
Lorpugo: folds
Uncalled bet ($025) returned to [chr1StaR]
[chr1StaR] collected $050 from pot
[chr1StaR]: doesn't show hand
*** SUMMARY ***
Total pot $050 | Rake $0
Seat 1: Lorpugo (button) (small blind) folded before Flop
Seat 2: [chr1StaR] (big blind) collected ($050)


*********** # 92 **************
PokerStars Zoom Hand #236067921183: Hold'em No Limit ($025/$050) - 2022/05/11 19:10:24 ET
Table 'C Carinae' 2-max Seat #1 is the button
Seat 1: marcmm36 ($2468 in chips)
Seat 2: Lorpugo ($25 in chips)
marcmm36: posts small blind $025
Lorpugo: posts big blind $050
*** HOLE CARDS ***
Dealt to Lorpugo [5s Qc]
marcmm36: calls $025
Lorpugo: checks
*** FLOP *** [Ks 8d Tc]
Lorpugo: checks
marcmm36: checks
*** TURN *** [Ks 8d Tc] [3d]
Lorpugo: checks
marcmm36: checks
*** RIVER *** [Ks 8d Tc 3d] [3c]
Lorpugo: bets $095
marcmm36: calls $095
*** SHOW DOWN ***
Lorpugo: shows [5s Qc] (a pair of Threes)
marcmm36: shows [8s Jc] (two pair, Eights and Threes)
marcmm36 collected $276 from pot
*** SUMMARY ***
Total pot $290 | Rake $014
Board [Ks 8d Tc 3d 3c]
Seat 1: marcmm36 (button) (small blind) showed [8s Jc] and won ($276) with two pair, Eights and Threes
Seat 2: Lorpugo (big blind) showed [5s Qc] and lost with a pair of Threes


*********** # 93 **************
PokerStars Zoom Hand #236067910821: Hold'em No Limit ($025/$050) - 2022/05/11 19:09:48 ET
Table 'C Carinae' 2-max Seat #1 is the button
Seat 1: Lorpugo ($1303 in chips)
Seat 2: Skala13220 ($10616 in chips)
Lorpugo: posts small blind $025
Skala13220: posts big blind $050
*** HOLE CARDS ***
Dealt to Lorpugo [Ts Js]
Lorpugo: calls $025
Skala13220: raises $1 to $150
Lorpugo: calls $1
*** FLOP *** [2h Jd 2c]
Skala13220: bets $157
Lorpugo: calls $157
*** TURN *** [2h Jd 2c] [5c]
Skala13220: bets $204
Lorpugo: raises $792 to $996 and is all-in
Skala13220: calls $792
*** RIVER *** [2h Jd 2c 5c] [Ah]
Lorpugo: prays
*** SHOW DOWN ***
Skala13220: shows [5d 5s] (a full house, Fives full of Deuces)
Lorpugo: shows [Ts Js] (two pair, Jacks and Deuces)
Skala13220 collected $2531 from pot
*** SUMMARY ***
Total pot $2606 | Rake $075
Board [2h Jd 2c 5c Ah]
Seat 1: Lorpugo (button) (small blind) showed [Ts Js] and lost with two pair, Jacks and Deuces
Seat 2: Skala13220 (big blind) showed [5d 5s] and won ($2531) with a full house, Fives full of Deuces


*********** # 94 **************
PokerStars Zoom Hand #236067901784: Hold'em No Limit ($025/$050) - 2022/05/11 19:09:28 ET
Table 'C Carinae' 2-max Seat #1 is the button
Seat 1: Skala13220 ($10791 in chips)
Seat 2: Lorpugo ($1146 in chips)
Skala13220: posts small blind $025
Lorpugo: posts big blind $050
*** HOLE CARDS ***
Dealt to Lorpugo [7s 6s]
Skala13220: raises $050 to $1
Lorpugo: calls $050
*** FLOP *** [4h 6d Kd]
Lorpugo: checks
Skala13220: bets $075
Lorpugo: calls $075
*** TURN *** [4h 6d Kd] [Jc]
Lorpugo: checks
Skala13220: checks
*** RIVER *** [4h 6d Kd Jc] [Ah]
Lorpugo: checks
Skala13220: checks
*** SHOW DOWN ***
Lorpugo: shows [7s 6s] (a pair of Sixes)
Skala13220: mucks hand
Lorpugo collected $332 from pot
*** SUMMARY ***
Total pot $350 | Rake $018
Board [4h 6d Kd Jc Ah]
Seat 1: Skala13220 (button) (small blind) mucked [5c 7h]
Seat 2: Lorpugo (big blind) showed [7s 6s] and won ($332) with a pair of Sixes


*********** # 95 **************
PokerStars Zoom Hand #236067898633: Hold'em No Limit ($025/$050) - 2022/05/11 19:09:17 ET
Table 'C Carinae' 2-max Seat #1 is the button
Seat 1: Lorpugo ($1096 in chips)
Seat 2: Pooface77 ($7647 in chips)
Lorpugo: posts small blind $025
Pooface77: posts big blind $050
*** HOLE CARDS ***
Dealt to Lorpugo [4h 8s]
Lorpugo: raises $1 to $150
Pooface77: folds
Uncalled bet ($1) returned to Lorpugo
Lorpugo collected $1 from pot
Lorpugo: doesn't show hand
*** SUMMARY ***
Total pot $1 | Rake $0
Seat 1: Lorpugo (button) (small blind) collected ($1)
Seat 2: Pooface77 (big blind) folded before Flop


*********** # 96 **************
PokerStars Zoom Hand #236067896279: Hold'em No Limit ($025/$050) - 2022/05/11 19:09:09 ET
Table 'C Carinae' 2-max Seat #1 is the button
Seat 1: Pooface77 ($7672 in chips)
Seat 2: Lorpugo ($1071 in chips)
Pooface77: posts small blind $025
Lorpugo: posts big blind $050
*** HOLE CARDS ***
Dealt to Lorpugo [6c 3h]
Pooface77: folds
Uncalled bet ($025) returned to Lorpugo
Lorpugo collected $050 from pot
Lorpugo: doesn't show hand
*** SUMMARY ***
Total pot $050 | Rake $0
Seat 1: Pooface77 (button) (small blind) folded before Flop
Seat 2: Lorpugo (big blind) collected ($050)


*********** # 97 **************
PokerStars Zoom Hand #236067893785: Hold'em No Limit ($025/$050) - 2022/05/11 19:09:01 ET
Table 'C Carinae' 2-max Seat #1 is the button
Seat 1: Lorpugo ($1096 in chips)
Seat 2: RemCavemin ($5126 in chips)
Lorpugo: posts small blind $025
RemCavemin: posts big blind $050
*** HOLE CARDS ***
Dealt to Lorpugo [4d 8c]
Lorpugo: folds
Uncalled bet ($025) returned to RemCavemin
RemCavemin collected $050 from pot
RemCavemin: doesn't show hand
*** SUMMARY ***
Total pot $050 | Rake $0
Seat 1: Lorpugo (button) (small blind) folded before Flop
Seat 2: RemCavemin (big blind) collected ($050)


*********** # 98 **************
PokerStars Zoom Hand #236067883957: Hold'em No Limit ($025/$050) - 2022/05/11 19:08:27 ET
Table 'C Carinae' 2-max Seat #1 is the button
Seat 1: RemCavemin ($5241 in chips)
Seat 2: Lorpugo ($993 in chips)
RemCavemin: posts small blind $025
Lorpugo: posts big blind $050
*** HOLE CARDS ***
Dealt to Lorpugo [Jc 7h]
RemCavemin: raises $065 to $115
Lorpugo: calls $065
*** FLOP *** [9h Qc 4s]
Lorpugo: checks
RemCavemin: checks
*** TURN *** [9h Qc 4s] [9d]
Lorpugo: checks
RemCavemin: checks
*** RIVER *** [9h Qc 4s 9d] [9s]
Lorpugo: bets $050
RemCavemin: folds
Uncalled bet ($050) returned to Lorpugo
Lorpugo collected $218 from pot
Lorpugo: doesn't show hand
*** SUMMARY ***
Total pot $230 | Rake $012
Board [9h Qc 4s 9d 9s]
Seat 1: RemCavemin (button) (small blind) folded on the River
Seat 2: Lorpugo (big blind) collected ($218)


*********** # 99 **************
PokerStars Zoom Hand #236067872778: Hold'em No Limit ($025/$050) - 2022/05/11 19:07:49 ET
Table 'C Carinae' 2-max Seat #1 is the button
Seat 1: Lorpugo ($1143 in chips)
Seat 2: RemCavemin ($5110 in chips)
Lorpugo: posts small blind $025
RemCavemin: posts big blind $050
*** HOLE CARDS ***
Dealt to Lorpugo [3s Kh]
Lorpugo: raises $050 to $1
RemCavemin: calls $050
*** FLOP *** [5s 8s 6s]
RemCavemin: checks
Lorpugo: bets $050
RemCavemin: calls $050
*** TURN *** [5s 8s 6s] [Ac]
RemCavemin: checks
Lorpugo: checks
*** RIVER *** [5s 8s 6s Ac] [6d]
RemCavemin: checks
Lorpugo: checks
*** SHOW DOWN ***
RemCavemin: shows [9h Ad] (two pair, Aces and Sixes)
Lorpugo: mucks hand
RemCavemin collected $281 from pot
*** SUMMARY ***
Total pot $3 | Rake $019
Board [5s 8s 6s Ac 6d]
Seat 1: Lorpugo (button) (small blind) mucked [3s Kh]
Seat 2: RemCavemin (big blind) showed [9h Ad] and won ($281) with two pair, Aces and Sixes


*********** # 100 **************
PokerStars Zoom Hand #236067869807: Hold'em No Limit ($025/$050) - 2022/05/11 19:07:39 ET
Table 'C Carinae' 2-max Seat #1 is the button
Seat 1: DzemAs ($5273 in chips)
Seat 2: Lorpugo ($1118 in chips)
DzemAs: posts small blind $025
Lorpugo: posts big blind $050
*** HOLE CARDS ***
Dealt to Lorpugo [Jh 7s]
DzemAs: folds
Uncalled bet ($025) returned to Lorpugo
Lorpugo collected $050 from pot
Lorpugo: doesn't show hand
*** SUMMARY ***
Total pot $050 | Rake $0
Seat 1: DzemAs (button) (small blind) folded before Flop
Seat 2: Lorpugo (big blind) collected ($050)


*********** # 101 **************
PokerStars Zoom Hand #236067868292: Hold'em No Limit ($025/$050) - 2022/05/11 19:07:34 ET
Table 'C Carinae' 2-max Seat #1 is the button
Seat 1: Lorpugo ($1143 in chips)
Seat 2: RemCavemin ($5110 in chips)
Lorpugo: posts small blind $025
RemCavemin: posts big blind $050
*** HOLE CARDS ***
Dealt to Lorpugo [2h Js]
Lorpugo: folds
Uncalled bet ($025) returned to RemCavemin
RemCavemin collected $050 from pot
RemCavemin: doesn't show hand
*** SUMMARY ***
Total pot $050 | Rake $0
Seat 1: Lorpugo (button) (small blind) folded before Flop
Seat 2: RemCavemin (big blind) collected ($050)


*********** # 102 **************
PokerStars Zoom Hand #236067866226: Hold'em No Limit ($025/$050) - 2022/05/11 19:07:27 ET
Table 'C Carinae' 2-max Seat #1 is the button
Seat 1: Nbg453 ($14498 in chips)
Seat 2: Lorpugo ($1193 in chips)
Nbg453: posts small blind $025
Lorpugo: posts big blind $050
*** HOLE CARDS ***
Dealt to Lorpugo [6s Qc]
Nbg453: raises $1 to $150
Lorpugo: folds
Uncalled bet ($1) returned to Nbg453
Nbg453 collected $1 from pot
Nbg453: doesn't show hand
*** SUMMARY ***
Total pot $1 | Rake $0
Seat 1: Nbg453 (button) (small blind) collected ($1)
Seat 2: Lorpugo (big blind) folded before Flop


*********** # 103 **************
PokerStars Zoom Hand #236067850198: Hold'em No Limit ($025/$050) - 2022/05/11 19:06:33 ET
Table 'C Carinae' 2-max Seat #1 is the button
Seat 1: Lorpugo ($1589 in chips)
Seat 2: Skala13220 ($9548 in chips)
Lorpugo: posts small blind $025
Skala13220: posts big blind $050
*** HOLE CARDS ***
Dealt to Lorpugo [9c 7h]
Lorpugo: raises $050 to $1
Skala13220: calls $050
*** FLOP *** [8s Jh 5h]
Skala13220: checks
Lorpugo: bets $063
Skala13220: calls $063
*** TURN *** [8s Jh 5h] [9s]
Skala13220: bets $233
Lorpugo: calls $233
*** RIVER *** [8s Jh 5h 9s] [Ad]
Skala13220: bets $16
Lorpugo: folds
Uncalled bet ($16) returned to Skala13220
Skala13220 collected $752 from pot
Skala13220: doesn't show hand
*** SUMMARY ***
Total pot $792 | Rake $040
Board [8s Jh 5h 9s Ad]
Seat 1: Lorpugo (button) (small blind) folded on the River
Seat 2: Skala13220 (big blind) collected ($752)


*********** # 104 **************
PokerStars Zoom Hand #236067841156: Hold'em No Limit ($025/$050) - 2022/05/11 19:06:02 ET
Table 'C Carinae' 2-max Seat #1 is the button
Seat 1: autoactor ($979 in chips)
Seat 2: Lorpugo ($1879 in chips)
autoactor: posts small blind $025
Lorpugo: posts big blind $050
*** HOLE CARDS ***
Dealt to Lorpugo [5d 3h]
autoactor: calls $025
Lorpugo: checks
*** FLOP *** [2h 4h Kd]
Lorpugo: checks
autoactor: bets $050
Lorpugo: calls $050
*** TURN *** [2h 4h Kd] [Ks]
Lorpugo: checks
autoactor: bets $190
Lorpugo: calls $190
*** RIVER *** [2h 4h Kd Ks] [3s]
Lorpugo: checks
autoactor: checks
*** SHOW DOWN ***
Lorpugo: shows [5d 3h] (two pair, Kings and Threes)
autoactor: shows [5s 4c] (two pair, Kings and Fours)
autoactor collected $544 from pot
*** SUMMARY ***
Total pot $580 | Rake $036
Board [2h 4h Kd Ks 3s]
Seat 1: autoactor (button) (small blind) showed [5s 4c] and won ($544) with two pair, Kings and Fours
Seat 2: Lorpugo (big blind) showed [5d 3h] and lost with two pair, Kings and Threes


*********** # 105 **************
PokerStars Zoom Hand #236067838576: Hold'em No Limit ($025/$050) - 2022/05/11 19:05:54 ET
Table 'C Carinae' 2-max Seat #1 is the button
Seat 1: Lorpugo ($1904 in chips)
Seat 2: marcmm36 ($4886 in chips)
Lorpugo: posts small blind $025
marcmm36: posts big blind $050
*** HOLE CARDS ***
Dealt to Lorpugo [2h 7d]
Lorpugo: folds
Uncalled bet ($025) returned to marcmm36
marcmm36 collected $050 from pot
marcmm36: doesn't show hand
*** SUMMARY ***
Total pot $050 | Rake $0
Seat 1: Lorpugo (button) (small blind) folded before Flop
Seat 2: marcmm36 (big blind) collected ($050)


*********** # 106 **************
PokerStars Zoom Hand #236067836432: Hold'em No Limit ($025/$050) - 2022/05/11 19:05:46 ET
Table 'C Carinae' 2-max Seat #1 is the button
Seat 1: Mich4elN ($32564 in chips)
Seat 2: Lorpugo ($1879 in chips)
Mich4elN: posts small blind $025
Lorpugo: posts big blind $050
*** HOLE CARDS ***
Dealt to Lorpugo [7c 5c]
Mich4elN: folds
Uncalled bet ($025) returned to Lorpugo
Lorpugo collected $050 from pot
Lorpugo: doesn't show hand
Mich4elN is disconnected
*** SUMMARY ***
Total pot $050 | Rake $0
Seat 1: Mich4elN (button) (small blind) folded before Flop
Seat 2: Lorpugo (big blind) collected ($050)


*********** # 107 **************
PokerStars Zoom Hand #236067831819: Hold'em No Limit ($025/$050) - 2022/05/11 19:05:31 ET
Table 'C Carinae' 2-max Seat #1 is the button
Seat 1: Lorpugo ($1766 in chips)
Seat 2: Skala13220 ($9174 in chips)
Lorpugo: posts small blind $025
Skala13220: posts big blind $050
*** HOLE CARDS ***
Dealt to Lorpugo [Qd 9d]
Lorpugo: raises $075 to $125
Skala13220: calls $075
*** FLOP *** [2s Ts 9h]
Skala13220: checks
Lorpugo: checks
*** TURN *** [2s Ts 9h] [Jh]
Skala13220: checks
Lorpugo: checks
*** RIVER *** [2s Ts 9h Jh] [Qc]
Skala13220: checks
Lorpugo: checks
*** SHOW DOWN ***
Skala13220: shows [6d 4c] (high card Queen)
Lorpugo: shows [Qd 9d] (two pair, Queens and Nines)
Lorpugo collected $238 from pot
*** SUMMARY ***
Total pot $250 | Rake $012
Board [2s Ts 9h Jh Qc]
Seat 1: Lorpugo (button) (small blind) showed [Qd 9d] and won ($238) with two pair, Queens and Nines
Seat 2: Skala13220 (big blind) showed [6d 4c] and lost with high card Queen


*********** # 108 **************
PokerStars Zoom Hand #236067822980: Hold'em No Limit ($025/$050) - 2022/05/11 19:05:05 ET
Table 'C Carinae' 2-max Seat #1 is the button
Seat 1: Skala13220 ($8898 in chips)
Seat 2: Lorpugo ($2073 in chips)
Skala13220: posts small blind $025
Lorpugo: posts big blind $050
*** HOLE CARDS ***
Dealt to Lorpugo [8h Qs]
Skala13220: raises $1 to $150
Lorpugo: calls $1
*** FLOP *** [Jd 9h 2d]
Lorpugo: checks
Skala13220: bets $157
Lorpugo: calls $157
*** TURN *** [Jd 9h 2d] [4s]
Lorpugo: checks
Skala13220: checks
*** RIVER *** [Jd 9h 2d 4s] [5h]
Lorpugo: checks
Skala13220: checks
*** SHOW DOWN ***
Lorpugo: shows [8h Qs] (high card Queen)
Skala13220: shows [5d Ad] (a pair of Fives)
Skala13220 collected $583 from pot
*** SUMMARY ***
Total pot $614 | Rake $031
Board [Jd 9h 2d 4s 5h]
Seat 1: Skala13220 (button) (small blind) showed [5d Ad] and won ($583) with a pair of Fives
Seat 2: Lorpugo (big blind) showed [8h Qs] and lost with high card Queen


*********** # 109 **************
PokerStars Zoom Hand #236067820029: Hold'em No Limit ($025/$050) - 2022/05/11 19:04:55 ET
Table 'C Carinae' 2-max Seat #1 is the button
Seat 1: Lorpugo ($2023 in chips)
Seat 2: ZenMisery ($50 in chips)
Lorpugo: posts small blind $025
ZenMisery: posts big blind $050
*** HOLE CARDS ***
Dealt to Lorpugo [Ks 3s]
Lorpugo: raises $075 to $125
ZenMisery: folds
Uncalled bet ($075) returned to Lorpugo
Lorpugo collected $1 from pot
Lorpugo: doesn't show hand
*** SUMMARY ***
Total pot $1 | Rake $0
Seat 1: Lorpugo (button) (small blind) collected ($1)
Seat 2: ZenMisery (big blind) folded before Flop


*********** # 110 **************
PokerStars Zoom Hand #236067816018: Hold'em No Limit ($025/$050) - 2022/05/11 19:04:42 ET
Table 'C Carinae' 2-max Seat #1 is the button
Seat 1: lukeylund ($15019 in chips)
Seat 2: Lorpugo ($1973 in chips)
lukeylund: posts small blind $025
Lorpugo: posts big blind $050
*** HOLE CARDS ***
Dealt to Lorpugo [Qc Ac]
lukeylund: calls $025
Lorpugo: raises $1 to $150
lukeylund: folds
Uncalled bet ($1) returned to Lorpugo
Lorpugo collected $1 from pot
Lorpugo: doesn't show hand
lukeylund is disconnected
*** SUMMARY ***
Total pot $1 | Rake $0
Seat 1: lukeylund (button) (small blind) folded before Flop
Seat 2: Lorpugo (big blind) collected ($1)


*********** # 111 **************
PokerStars Zoom Hand #236067813381: Hold'em No Limit ($025/$050) - 2022/05/11 19:04:33 ET
Table 'C Carinae' 2-max Seat #1 is the button
Seat 1: Lorpugo ($1923 in chips)
Seat 2: DzemAs ($5935 in chips)
Lorpugo: posts small blind $025
DzemAs: posts big blind $050
*** HOLE CARDS ***
Dealt to Lorpugo [6d Td]
Lorpugo: raises $075 to $125
DzemAs: folds
Uncalled bet ($075) returned to Lorpugo
Lorpugo collected $1 from pot
Lorpugo: doesn't show hand
*** SUMMARY ***
Total pot $1 | Rake $0
Seat 1: Lorpugo (button) (small blind) collected ($1)
Seat 2: DzemAs (big blind) folded before Flop


*********** # 112 **************
PokerStars Zoom Hand #236067811002: Hold'em No Limit ($025/$050) - 2022/05/11 19:04:25 ET
Table 'C Carinae' 2-max Seat #1 is the button
Seat 1: Nbg453 ($15719 in chips)
Seat 2: Lorpugo ($1898 in chips)
Nbg453: posts small blind $025
Lorpugo: posts big blind $050
*** HOLE CARDS ***
Dealt to Lorpugo [2c Qc]
Nbg453: folds
Uncalled bet ($025) returned to Lorpugo
Lorpugo collected $050 from pot
Lorpugo: doesn't show hand
Nbg453 is disconnected
*** SUMMARY ***
Total pot $050 | Rake $0
Seat 1: Nbg453 (button) (small blind) folded before Flop
Seat 2: Lorpugo (big blind) collected ($050)


*********** # 113 **************
PokerStars Zoom Hand #236067809147: Hold'em No Limit ($025/$050) - 2022/05/11 19:04:19 ET
Table 'C Carinae' 2-max Seat #1 is the button
Seat 1: Lorpugo ($1923 in chips)
Seat 2: Nbg453 ($15694 in chips)
Lorpugo: posts small blind $025
Nbg453: posts big blind $050
*** HOLE CARDS ***
Dealt to Lorpugo [Th 5s]
Lorpugo: folds
Uncalled bet ($025) returned to Nbg453
Nbg453 collected $050 from pot
Nbg453: doesn't show hand
*** SUMMARY ***
Total pot $050 | Rake $0
Seat 1: Lorpugo (button) (small blind) folded before Flop
Seat 2: Nbg453 (big blind) collected ($050)


*********** # 114 **************
PokerStars Zoom Hand #236067800701: Hold'em No Limit ($025/$050) - 2022/05/11 19:03:51 ET
Table 'C Carinae' 2-max Seat #1 is the button
Seat 1: Nbg453 ($15189 in chips)
Seat 2: Lorpugo ($25 in chips)
Nbg453: posts small blind $025
Lorpugo: posts big blind $050
*** HOLE CARDS ***
Dealt to Lorpugo [7s 5h]
Nbg453: raises $1 to $150
Lorpugo: calls $1
*** FLOP *** [8d 2h As]
Lorpugo: checks
Nbg453: bets $142
Lorpugo: raises $285 to $427
Nbg453: calls $285
*** TURN *** [8d 2h As] [Th]
Lorpugo: checks
Nbg453: bets $14612 and is all-in
Lorpugo: folds
Uncalled bet ($14612) returned to Nbg453
Nbg453 collected $1082 from pot
Nbg453: doesn't show hand
*** SUMMARY ***
Total pot $1154 | Rake $072
Board [8d 2h As Th]
Seat 1: Nbg453 (button) (small blind) collected ($1082)
Seat 2: Lorpugo (big blind) folded on the Turn


*********** # 115 **************
PokerStars Zoom Hand #236067792453: Hold'em No Limit ($025/$050) - 2022/05/11 19:03:23 ET
Table 'C Carinae' 2-max Seat #1 is the button
Seat 1: Lorpugo ($3972 in chips)
Seat 2: Pooface77 ($8972 in chips)
Lorpugo: posts small blind $025
Pooface77: posts big blind $050
*** HOLE CARDS ***
Dealt to Lorpugo [4d 7s]
Lorpugo: folds
Uncalled bet ($025) returned to Pooface77
Pooface77 collected $050 from pot
Pooface77: doesn't show hand
*** SUMMARY ***
Total pot $050 | Rake $0
Seat 1: Lorpugo (button) (small blind) folded before Flop
Seat 2: Pooface77 (big blind) collected ($050)


*********** # 116 **************
PokerStars Zoom Hand #236067771824: Hold'em No Limit ($025/$050) - 2022/05/11 19:02:13 ET
Table 'C Carinae' 2-max Seat #1 is the button
Seat 1: Pooface77 ($10098 in chips)
Seat 2: Lorpugo ($2921 in chips)
Pooface77: posts small blind $025
Lorpugo: posts big blind $050
*** HOLE CARDS ***
Dealt to Lorpugo [Kc Qs]
Pooface77: raises $075 to $125
Lorpugo: raises $3 to $425
Pooface77: calls $3
*** FLOP *** [8c 2s 4c]
Lorpugo: bets $267
Pooface77: calls $267
*** TURN *** [8c 2s 4c] [Th]
Lorpugo: bets $434
Pooface77: calls $434
*** RIVER *** [8c 2s 4c Th] [Kd]
Lorpugo: bets $1795 and is all-in
Pooface77: folds
Uncalled bet ($1795) returned to Lorpugo
Lorpugo collected $2177 from pot
Lorpugo: doesn't show hand
*** SUMMARY ***
Total pot $2252 | Rake $075
Board [8c 2s 4c Th Kd]
Seat 1: Pooface77 (button) (small blind) folded on the River
Seat 2: Lorpugo (big blind) collected ($2177)


*********** # 117 **************
PokerStars Zoom Hand #236067769327: Hold'em No Limit ($025/$050) - 2022/05/11 19:02:04 ET
Table 'C Carinae' 2-max Seat #1 is the button
Seat 1: Lorpugo ($2946 in chips)
Seat 2: Nbg453 ($16410 in chips)
Lorpugo: posts small blind $025
Nbg453: posts big blind $050
*** HOLE CARDS ***
Dealt to Lorpugo [4c 2s]
Lorpugo: folds
Uncalled bet ($025) returned to Nbg453
Nbg453 collected $050 from pot
Nbg453: doesn't show hand
*** SUMMARY ***
Total pot $050 | Rake $0
Seat 1: Lorpugo (button) (small blind) folded before Flop
Seat 2: Nbg453 (big blind) collected ($050)


*********** # 118 **************
PokerStars Zoom Hand #236067748638: Hold'em No Limit ($025/$050) - 2022/05/11 19:00:52 ET
Table 'C Carinae' 2-max Seat #1 is the button
Seat 1: Kodeldowski ($5451 in chips)
Seat 2: Lorpugo ($25 in chips)
Kodeldowski: posts small blind $025
Lorpugo: posts big blind $050
*** HOLE CARDS ***
Dealt to Lorpugo [7c 6h]
Kodeldowski: raises $075 to $125
Lorpugo: calls $075
*** FLOP *** [5d Kd 8c]
Lorpugo: checks
Kodeldowski: bets $181
Lorpugo: calls $181
*** TURN *** [5d Kd 8c] [5s]
Lorpugo: bets $190
Kodeldowski: calls $190
*** RIVER *** [5d Kd 8c 5s] [As]
Lorpugo: bets $470
Kodeldowski: folds
Uncalled bet ($470) returned to Lorpugo
Lorpugo collected $942 from pot
Lorpugo: doesn't show hand
*** SUMMARY ***
Total pot $992 | Rake $050
Board [5d Kd 8c 5s As]
Seat 1: Kodeldowski (button) (small blind) folded on the River
Seat 2: Lorpugo (big blind) collected ($942)


*********** # 119 **************
PokerStars Zoom Hand #236067739241: Hold'em No Limit ($025/$050) - 2022/05/11 19:00:15 ET
Table 'C Carinae' 2-max Seat #1 is the button
Seat 1: Lorpugo ($5438 in chips)
Seat 2: PapaErik1 ($2031 in chips)
Lorpugo: posts small blind $025
PapaErik1: posts big blind $050
*** HOLE CARDS ***
Dealt to Lorpugo [Kd 7d]
Lorpugo: raises $075 to $125
PapaErik1: folds
Uncalled bet ($075) returned to Lorpugo
Lorpugo collected $1 from pot
Lorpugo: doesn't show hand
PapaErik1 is disconnected
*** SUMMARY ***
Total pot $1 | Rake $0
Seat 1: Lorpugo (button) (small blind) collected ($1)
Seat 2: PapaErik1 (big blind) folded before Flop


*********** # 120 **************
PokerStars Zoom Hand #236067738043: Hold'em No Limit ($025/$050) - 2022/05/11 19:00:10 ET
Table 'C Carinae' 2-max Seat #1 is the button
Seat 1: Lorpugo ($5463 in chips)
Seat 2: [chr1StaR] ($5222 in chips)
Lorpugo: posts small blind $025
[chr1StaR]: posts big blind $050
*** HOLE CARDS ***
Dealt to Lorpugo [8h 3s]
Lorpugo: folds
Uncalled bet ($025) returned to [chr1StaR]
[chr1StaR] collected $050 from pot
[chr1StaR]: doesn't show hand
*** SUMMARY ***
Total pot $050 | Rake $0
Seat 1: Lorpugo (button) (small blind) folded before Flop
Seat 2: [chr1StaR] (big blind) collected ($050)


*********** # 121 **************
PokerStars Zoom Hand #236067736098: Hold'em No Limit ($025/$050) - 2022/05/11 19:00:02 ET
Table 'C Carinae' 2-max Seat #1 is the button
Seat 1: RemCavemin ($5114 in chips)
Seat 2: Lorpugo ($5513 in chips)
RemCavemin: posts small blind $025
Lorpugo: posts big blind $050
*** HOLE CARDS ***
Dealt to Lorpugo [Th 2d]
RemCavemin: raises $065 to $115
Lorpugo: folds
Uncalled bet ($065) returned to RemCavemin
RemCavemin collected $1 from pot
RemCavemin: doesn't show hand
*** SUMMARY ***
Total pot $1 | Rake $0
Seat 1: RemCavemin (button) (small blind) collected ($1)
Seat 2: Lorpugo (big blind) folded before Flop


*********** # 122 **************
PokerStars Zoom Hand #236067732148: Hold'em No Limit ($025/$050) - 2022/05/11 18:59:46 ET
Table 'C Carinae' 2-max Seat #1 is the button
Seat 1: Kepez ($6123 in chips)
Seat 2: Lorpugo ($5563 in chips)
Kepez: posts small blind $025
Lorpugo: posts big blind $050
*** HOLE CARDS ***
Dealt to Lorpugo [5d 3h]
Kepez: raises $075 to $125
Lorpugo: folds
Uncalled bet ($075) returned to Kepez
Kepez collected $1 from pot
Kepez: doesn't show hand
*** SUMMARY ***
Total pot $1 | Rake $0
Seat 1: Kepez (button) (small blind) collected ($1)
Seat 2: Lorpugo (big blind) folded before Flop


*********** # 123 **************
PokerStars Zoom Hand #236067707710: Hold'em No Limit ($025/$050) - 2022/05/11 18:58:02 ET
Table 'C Carinae' 2-max Seat #1 is the button
Seat 1: Lorpugo ($4409 in chips)
Seat 2: Kepez ($7352 in chips)
Lorpugo: posts small blind $025
Kepez: posts big blind $050
*** HOLE CARDS ***
Dealt to Lorpugo [Ts Jd]
Lorpugo: raises $060 to $110
Kepez: calls $060
*** FLOP *** [Qd 2c 9d]
Kepez: checks
Lorpugo: bets $069
Kepez: calls $069
*** TURN *** [Qd 2c 9d] [7s]
Kepez: checks
Lorpugo: checks
*** RIVER *** [Qd 2c 9d 7s] [Ks]
Kepez: bets $503
Lorpugo: raises $547 to $1050
Kepez: calls $547
*** SHOW DOWN ***
Lorpugo: shows [Ts Jd] (a straight, Nine to King)
Kepez: mucks hand
Lorpugo collected $2383 from pot
*** SUMMARY ***
Total pot $2458 | Rake $075
Board [Qd 2c 9d 7s Ks]
Seat 1: Lorpugo (button) (small blind) showed [Ts Jd] and won ($2383) with a straight, Nine to King
Seat 2: Kepez (big blind) mucked [Kd 9h]


*********** # 124 **************
PokerStars Zoom Hand #236067705599: Hold'em No Limit ($025/$050) - 2022/05/11 18:57:54 ET
Table 'C Carinae' 2-max Seat #1 is the button
Seat 1: Pooface77 ($5953 in chips)
Seat 2: Lorpugo ($4384 in chips)
Pooface77: posts small blind $025
Lorpugo: posts big blind $050
*** HOLE CARDS ***
Dealt to Lorpugo [Js 5c]
Pooface77: folds
Uncalled bet ($025) returned to Lorpugo
Lorpugo collected $050 from pot
Lorpugo: doesn't show hand
*** SUMMARY ***
Total pot $050 | Rake $0
Seat 1: Pooface77 (button) (small blind) folded before Flop
Seat 2: Lorpugo (big blind) collected ($050)


*********** # 125 **************
PokerStars Zoom Hand #236067700117: Hold'em No Limit ($025/$050) - 2022/05/11 18:57:30 ET
Table 'C Carinae' 2-max Seat #1 is the button
Seat 1: Lorpugo ($4294 in chips)
Seat 2: lukeylund ($13992 in chips)
Lorpugo: posts small blind $025
lukeylund: posts big blind $050
*** HOLE CARDS ***
Dealt to Lorpugo [Jd 8s]
Lorpugo: raises $050 to $1
lukeylund: calls $050
*** FLOP *** [As Ks 3d]
lukeylund: checks
Lorpugo: bets $064
lukeylund: folds
Uncalled bet ($064) returned to Lorpugo
Lorpugo collected $190 from pot
Lorpugo: doesn't show hand
lukeylund is disconnected
*** SUMMARY ***
Total pot $2 | Rake $010
Board [As Ks 3d]
Seat 1: Lorpugo (button) (small blind) collected ($190)
Seat 2: lukeylund (big blind) folded on the Flop


*********** # 126 **************
PokerStars Zoom Hand #236067689179: Hold'em No Limit ($025/$050) - 2022/05/11 18:56:44 ET
Table 'C Carinae' 2-max Seat #1 is the button
Seat 1: lukeylund ($13787 in chips)
Seat 2: Lorpugo ($4522 in chips)
lukeylund: posts small blind $025
Lorpugo: posts big blind $050
*** HOLE CARDS ***
Dealt to Lorpugo [Kd Tc]
lukeylund: raises $095 to $145
Lorpugo: calls $095
*** FLOP *** [4d 2d 7c]
Lorpugo: checks
lukeylund: checks
*** TURN *** [4d 2d 7c] [Ah]
Lorpugo: checks
lukeylund: bets $083
Lorpugo: calls $083
*** RIVER *** [4d 2d 7c Ah] [Qs]
Lorpugo: checks
lukeylund: checks
*** SHOW DOWN ***
Lorpugo: shows [Kd Tc] (high card Ace)
lukeylund: shows [Jc Qh] (a pair of Queens)
lukeylund collected $433 from pot
*** SUMMARY ***
Total pot $456 | Rake $023
Board [4d 2d 7c Ah Qs]
Seat 1: lukeylund (button) (small blind) showed [Jc Qh] and won ($433) with a pair of Queens
Seat 2: Lorpugo (big blind) showed [Kd Tc] and lost with high card Ace


*********** # 127 **************
PokerStars Zoom Hand #236067687056: Hold'em No Limit ($025/$050) - 2022/05/11 18:56:35 ET
Table 'C Carinae' 2-max Seat #1 is the button
Seat 1: Lorpugo ($4547 in chips)
Seat 2: Kodeldowski ($11228 in chips)
Lorpugo: posts small blind $025
Kodeldowski: posts big blind $050
*** HOLE CARDS ***
Dealt to Lorpugo [6h 3d]
Lorpugo: folds
Uncalled bet ($025) returned to Kodeldowski
Kodeldowski collected $050 from pot
Kodeldowski: doesn't show hand
*** SUMMARY ***
Total pot $050 | Rake $0
Seat 1: Lorpugo (button) (small blind) folded before Flop
Seat 2: Kodeldowski (big blind) collected ($050)


*********** # 128 **************
PokerStars Zoom Hand #236067677890: Hold'em No Limit ($025/$050) - 2022/05/11 18:55:57 ET
Table 'C Carinae' 2-max Seat #1 is the button
Seat 1: Kodeldowski ($6410 in chips)
Seat 2: Lorpugo ($3847 in chips)
Kodeldowski: posts small blind $025
Lorpugo: posts big blind $050
*** HOLE CARDS ***
Dealt to Lorpugo [Tc Jh]
Kodeldowski: raises $075 to $125
Lorpugo: raises $250 to $375
Kodeldowski: calls $250
*** FLOP *** [Ad 8h 5h]
Lorpugo: bets $4
Kodeldowski: calls $4
*** TURN *** [Ad 8h 5h] [6s]
Lorpugo: checks
Kodeldowski: checks
*** RIVER *** [Ad 8h 5h 6s] [2h]
Lorpugo: bets $3072 and is all-in
Kodeldowski: folds
Uncalled bet ($3072) returned to Lorpugo
Lorpugo collected $1475 from pot
Lorpugo: doesn't show hand
*** SUMMARY ***
Total pot $1550 | Rake $075
Board [Ad 8h 5h 6s 2h]
Seat 1: Kodeldowski (button) (small blind) folded on the River
Seat 2: Lorpugo (big blind) collected ($1475)


*********** # 129 **************
PokerStars Zoom Hand #236067672908: Hold'em No Limit ($025/$050) - 2022/05/11 18:55:36 ET
Table 'C Carinae' 2-max Seat #1 is the button
Seat 1: Lorpugo ($3947 in chips)
Seat 2: jamesa261 ($4525 in chips)
Lorpugo: posts small blind $025
jamesa261: posts big blind $050
*** HOLE CARDS ***
Dealt to Lorpugo [9c 6h]
Lorpugo: raises $050 to $1
jamesa261: raises $350 to $450
Lorpugo: folds
Uncalled bet ($350) returned to jamesa261
jamesa261 collected $2 from pot
jamesa261: doesn't show hand
*** SUMMARY ***
Total pot $2 | Rake $0
Seat 1: Lorpugo (button) (small blind) folded before Flop
Seat 2: jamesa261 (big blind) collected ($2)


*********** # 130 **************
PokerStars Zoom Hand #236067666225: Hold'em No Limit ($025/$050) - 2022/05/11 18:55:08 ET
Table 'C Carinae' 2-max Seat #1 is the button
Seat 1: Lorpugo ($3897 in chips)
Seat 2: PapaErik1 ($3379 in chips)
Lorpugo: posts small blind $025
PapaErik1: posts big blind $050
*** HOLE CARDS ***
Dealt to Lorpugo [2c 7c]
Lorpugo: raises $050 to $1
PapaErik1: folds
Uncalled bet ($050) returned to Lorpugo
Lorpugo collected $1 from pot
Lorpugo: doesn't show hand
PapaErik1 is disconnected
*** SUMMARY ***
Total pot $1 | Rake $0
Seat 1: Lorpugo (button) (small blind) collected ($1)
Seat 2: PapaErik1 (big blind) folded before Flop


*********** # 131 **************
PokerStars Zoom Hand #236067659172: Hold'em No Limit ($025/$050) - 2022/05/11 18:54:43 ET
Table 'C Carinae' 2-max Seat #1 is the button
Seat 1: PapaErik1 ($3204 in chips)
Seat 2: Lorpugo ($4097 in chips)
PapaErik1: posts small blind $025
Lorpugo: posts big blind $050
*** HOLE CARDS ***
Dealt to Lorpugo [9h 6d]
PapaErik1: raises $050 to $1
Lorpugo: calls $050
*** FLOP *** [6c 3d Ks]
Lorpugo: checks
PapaErik1: checks
*** TURN *** [6c 3d Ks] [As]
Lorpugo: checks
PapaErik1: checks
*** RIVER *** [6c 3d Ks As] [2h]
Lorpugo: checks
PapaErik1: bets $1
Lorpugo: calls $1
*** SHOW DOWN ***
PapaErik1: shows [Qh Kd] (a pair of Kings)
Lorpugo: mucks hand
PapaErik1 collected $375 from pot
*** SUMMARY ***
Total pot $4 | Rake $025
Board [6c 3d Ks As 2h]
Seat 1: PapaErik1 (button) (small blind) showed [Qh Kd] and won ($375) with a pair of Kings
Seat 2: Lorpugo (big blind) mucked [9h 6d]


*********** # 132 **************
PokerStars Zoom Hand #236067657383: Hold'em No Limit ($025/$050) - 2022/05/11 18:54:37 ET
Table 'C Carinae' 2-max Seat #1 is the button
Seat 1: Kodeldowski ($6394 in chips)
Seat 2: Lorpugo ($4072 in chips)
Kodeldowski: posts small blind $025
Lorpugo: posts big blind $050
*** HOLE CARDS ***
Dealt to Lorpugo [4d Th]
Kodeldowski: folds
Uncalled bet ($025) returned to Lorpugo
Lorpugo collected $050 from pot
Lorpugo: doesn't show hand
*** SUMMARY ***
Total pot $050 | Rake $0
Seat 1: Kodeldowski (button) (small blind) folded before Flop
Seat 2: Lorpugo (big blind) collected ($050)


*********** # 133 **************
PokerStars Zoom Hand #236067650484: Hold'em No Limit ($025/$050) - 2022/05/11 18:54:14 ET
Table 'C Carinae' 2-max Seat #1 is the button
Seat 1: Lorpugo ($3414 in chips)
Seat 2: drissmouzou ($3671 in chips)
Lorpugo: posts small blind $025
drissmouzou: posts big blind $050
*** HOLE CARDS ***
Dealt to Lorpugo [Qh 5h]
Lorpugo: raises $075 to $125
drissmouzou: raises $250 to $375
Lorpugo: calls $250
*** FLOP *** [8d 3h 5d]
drissmouzou: bets $356
Lorpugo: raises $2683 to $3039 and is all-in
drissmouzou: folds
Uncalled bet ($2683) returned to Lorpugo
Lorpugo collected $1389 from pot
Lorpugo: doesn't show hand
*** SUMMARY ***
Total pot $1462 | Rake $073
Board [8d 3h 5d]
Seat 1: Lorpugo (button) (small blind) collected ($1389)
Seat 2: drissmouzou (big blind) folded on the Flop


*********** # 134 **************
PokerStars Zoom Hand #236067648550: Hold'em No Limit ($025/$050) - 2022/05/11 18:54:08 ET
Table 'C Carinae' 2-max Seat #1 is the button
Seat 1: Kodeldowski ($6569 in chips)
Seat 2: Lorpugo ($3389 in chips)
Kodeldowski: posts small blind $025
Lorpugo: posts big blind $050
*** HOLE CARDS ***
Dealt to Lorpugo [7c Qs]
Kodeldowski: folds
Uncalled bet ($025) returned to Lorpugo
Lorpugo collected $050 from pot
Lorpugo: doesn't show hand
*** SUMMARY ***
Total pot $050 | Rake $0
Seat 1: Kodeldowski (button) (small blind) folded before Flop
Seat 2: Lorpugo (big blind) collected ($050)


*********** # 135 **************
PokerStars Zoom Hand #236067646770: Hold'em No Limit ($025/$050) - 2022/05/11 18:54:02 ET
Table 'C Carinae' 2-max Seat #1 is the button
Seat 1: Lorpugo ($3414 in chips)
Seat 2: Kepez ($5055 in chips)
Lorpugo: posts small blind $025
Kepez: posts big blind $050
*** HOLE CARDS ***
Dealt to Lorpugo [3c Jh]
Lorpugo: folds
Uncalled bet ($025) returned to Kepez
Kepez collected $050 from pot
Kepez: doesn't show hand
*** SUMMARY ***
Total pot $050 | Rake $0
Seat 1: Lorpugo (button) (small blind) folded before Flop
Seat 2: Kepez (big blind) collected ($050)


*********** # 136 **************
PokerStars Zoom Hand #236067643752: Hold'em No Limit ($025/$050) - 2022/05/11 18:53:52 ET
Table 'C Carinae' 2-max Seat #1 is the button
Seat 1: Lorpugo ($3364 in chips)
Seat 2: KrisMcC81 ($22141 in chips)
Lorpugo: posts small blind $025
KrisMcC81: posts big blind $050
*** HOLE CARDS ***
Dealt to Lorpugo [Js Td]
Lorpugo: raises $075 to $125
KrisMcC81: folds
Uncalled bet ($075) returned to Lorpugo
Lorpugo collected $1 from pot
Lorpugo: doesn't show hand
*** SUMMARY ***
Total pot $1 | Rake $0
Seat 1: Lorpugo (button) (small blind) collected ($1)
Seat 2: KrisMcC81 (big blind) folded before Flop


*********** # 137 **************
PokerStars Zoom Hand #236067628468: Hold'em No Limit ($025/$050) - 2022/05/11 18:53:03 ET
Table 'C Carinae' 2-max Seat #1 is the button
Seat 1: Kepez ($8151 in chips)
Seat 2: Lorpugo ($3555 in chips)
Kepez: posts small blind $025
Lorpugo: posts big blind $050
*** HOLE CARDS ***
Dealt to Lorpugo [6h Jh]
Kepez: raises $075 to $125
Lorpugo: calls $075
*** FLOP *** [5s 7c Ks]
Lorpugo: checks
Kepez: checks
*** TURN *** [5s 7c Ks] [Kh]
Lorpugo: bets $066
Kepez: raises $189 to $255
Lorpugo: folds
Uncalled bet ($189) returned to Kepez
Kepez collected $363 from pot
Kepez: doesn't show hand
*** SUMMARY ***
Total pot $382 | Rake $019
Board [5s 7c Ks Kh]
Seat 1: Kepez (button) (small blind) collected ($363)
Seat 2: Lorpugo (big blind) folded on the Turn


*********** # 138 **************
PokerStars Zoom Hand #236067619090: Hold'em No Limit ($025/$050) - 2022/05/11 18:52:33 ET
Table 'C Carinae' 2-max Seat #1 is the button
Seat 1: Lorpugo ($3465 in chips)
Seat 2: Mich4elN ($32104 in chips)
Lorpugo: posts small blind $025
Mich4elN: posts big blind $050
*** HOLE CARDS ***
Dealt to Lorpugo [8d 7c]
Lorpugo: raises $050 to $1
Mich4elN: calls $050
*** FLOP *** [Ac Qc 4d]
Mich4elN: checks
Lorpugo: bets $063
Mich4elN: folds
Uncalled bet ($063) returned to Lorpugo
Lorpugo collected $190 from pot
Lorpugo: doesn't show hand
Mich4elN is disconnected
*** SUMMARY ***
Total pot $2 | Rake $010
Board [Ac Qc 4d]
Seat 1: Lorpugo (button) (small blind) collected ($190)
Seat 2: Mich4elN (big blind) folded on the Flop


*********** # 139 **************
PokerStars Zoom Hand #236067613807: Hold'em No Limit ($025/$050) - 2022/05/11 18:52:16 ET
Table 'C Carinae' 2-max Seat #1 is the button
Seat 1: yazshuai ($13831 in chips)
Seat 2: Lorpugo ($3227 in chips)
yazshuai: posts small blind $025
Lorpugo: posts big blind $050
*** HOLE CARDS ***
Dealt to Lorpugo [Kh 4s]
yazshuai: raises $1 to $150
Lorpugo: calls $1
*** FLOP *** [2d 6c 4c]
Lorpugo: checks
yazshuai: bets $114
Lorpugo: raises $2963 to $3077 and is all-in
yazshuai: folds
Uncalled bet ($2963) returned to Lorpugo
Lorpugo collected $502 from pot
Lorpugo: doesn't show hand
yazshuai is disconnected
*** SUMMARY ***
Total pot $528 | Rake $026
Board [2d 6c 4c]
Seat 1: yazshuai (button) (small blind) folded on the Flop
Seat 2: Lorpugo (big blind) collected ($502)


*********** # 140 **************
PokerStars Zoom Hand #236067601332: Hold'em No Limit ($025/$050) - 2022/05/11 18:51:36 ET
Table 'C Carinae' 2-max Seat #1 is the button
Seat 1: irishboy_112 ($3361 in chips)
Seat 2: Lorpugo ($3177 in chips)
irishboy_112: posts small blind $025
Lorpugo: posts big blind $050
*** HOLE CARDS ***
Dealt to Lorpugo [Ac 2s]
irishboy_112: calls $025
Lorpugo: raises $150 to $2
irishboy_112: folds
Uncalled bet ($150) returned to Lorpugo
Lorpugo collected $1 from pot
Lorpugo: doesn't show hand
irishboy_112 is disconnected
*** SUMMARY ***
Total pot $1 | Rake $0
Seat 1: irishboy_112 (button) (small blind) folded before Flop
Seat 2: Lorpugo (big blind) collected ($1)


*********** # 141 **************
PokerStars Zoom Hand #236067587276: Hold'em No Limit ($025/$050) - 2022/05/11 18:50:50 ET
Table 'C Carinae' 2-max Seat #1 is the button
Seat 1: Lorpugo ($2751 in chips)
Seat 2: irishboy_112 ($3834 in chips)
Lorpugo: posts small blind $025
irishboy_112: posts big blind $050
*** HOLE CARDS ***
Dealt to Lorpugo [9c 4c]
Lorpugo: raises $050 to $1
irishboy_112: calls $050
*** FLOP *** [4h 8c Ac]
irishboy_112: checks
Lorpugo: bets $063
irishboy_112: calls $063
*** TURN *** [4h 8c Ac] [8h]
irishboy_112: checks
Lorpugo: checks
*** RIVER *** [4h 8c Ac 8h] [9d]
irishboy_112: bets $310
Lorpugo: calls $310
*** SHOW DOWN ***
irishboy_112: shows [Jh Qc] (a pair of Eights)
Lorpugo: shows [9c 4c] (two pair, Nines and Eights)
Lorpugo collected $899 from pot
*** SUMMARY ***
Total pot $946 | Rake $047
Board [4h 8c Ac 8h 9d]
Seat 1: Lorpugo (button) (small blind) showed [9c 4c] and won ($899) with two pair, Nines and Eights
Seat 2: irishboy_112 (big blind) showed [Jh Qc] and lost with a pair of Eights


*********** # 142 **************
PokerStars Zoom Hand #236067584744: Hold'em No Limit ($025/$050) - 2022/05/11 18:50:42 ET
Table 'C Carinae' 2-max Seat #1 is the button
Seat 1: autoactor ($1677 in chips)
Seat 2: Lorpugo ($2801 in chips)
autoactor: posts small blind $025
Lorpugo: posts big blind $050
*** HOLE CARDS ***
Dealt to Lorpugo [5d Ad]
autoactor: raises $1627 to $1677 and is all-in
Lorpugo: folds
Uncalled bet ($1627) returned to autoactor
autoactor collected $1 from pot
autoactor: doesn't show hand
*** SUMMARY ***
Total pot $1 | Rake $0
Seat 1: autoactor (button) (small blind) collected ($1)
Seat 2: Lorpugo (big blind) folded before Flop


*********** # 143 **************
PokerStars Zoom Hand #236067583250: Hold'em No Limit ($025/$050) - 2022/05/11 18:50:38 ET
Table 'C Carinae' 2-max Seat #1 is the button
Seat 1: Lorpugo ($2826 in chips)
Seat 2: Skala13220 ($9422 in chips)
Lorpugo: posts small blind $025
Skala13220: posts big blind $050
*** HOLE CARDS ***
Dealt to Lorpugo [6d 2c]
Lorpugo: folds
Uncalled bet ($025) returned to Skala13220
Skala13220 collected $050 from pot
Skala13220: doesn't show hand
*** SUMMARY ***
Total pot $050 | Rake $0
Seat 1: Lorpugo (button) (small blind) folded before Flop
Seat 2: Skala13220 (big blind) collected ($050)


*********** # 144 **************
PokerStars Zoom Hand #236067580427: Hold'em No Limit ($025/$050) - 2022/05/11 18:50:29 ET
Table 'C Carinae' 2-max Seat #1 is the button
Seat 1: Kepez ($5186 in chips)
Seat 2: Lorpugo ($2876 in chips)
Kepez: posts small blind $025
Lorpugo: posts big blind $050
*** HOLE CARDS ***
Dealt to Lorpugo [Td 5c]
Kepez: raises $075 to $125
Lorpugo: folds
Uncalled bet ($075) returned to Kepez
Kepez collected $1 from pot
Kepez: doesn't show hand
*** SUMMARY ***
Total pot $1 | Rake $0
Seat 1: Kepez (button) (small blind) collected ($1)
Seat 2: Lorpugo (big blind) folded before Flop


*********** # 145 **************
PokerStars Zoom Hand #236067578571: Hold'em No Limit ($025/$050) - 2022/05/11 18:50:23 ET
Table 'C Carinae' 2-max Seat #1 is the button
Seat 1: Lorpugo ($2901 in chips)
Seat 2: Pooface77 ($50 in chips)
Lorpugo: posts small blind $025
Pooface77: posts big blind $050
*** HOLE CARDS ***
Dealt to Lorpugo [8h 3c]
Lorpugo: folds
Uncalled bet ($025) returned to Pooface77
Pooface77 collected $050 from pot
Pooface77: doesn't show hand
*** SUMMARY ***
Total pot $050 | Rake $0
Seat 1: Lorpugo (button) (small blind) folded before Flop
Seat 2: Pooface77 (big blind) collected ($050)


*********** # 146 **************
PokerStars Zoom Hand #236067563628: Hold'em No Limit ($025/$050) - 2022/05/11 18:49:34 ET
Table 'C Carinae' 2-max Seat #1 is the button
Seat 1: Pooface77 ($5115 in chips)
Seat 2: Lorpugo ($25 in chips)
Pooface77: posts small blind $025
Lorpugo: posts big blind $050
*** HOLE CARDS ***
Dealt to Lorpugo [Kd Jh]
Pooface77: raises $075 to $125
Lorpugo: calls $075
*** FLOP *** [3c Qs 7h]
Lorpugo: checks
Pooface77: bets $071
Lorpugo: calls $071
*** TURN *** [3c Qs 7h] [7c]
Lorpugo: checks
Pooface77: checks
*** RIVER *** [3c Qs 7h 7c] [As]
Lorpugo: checks
Pooface77: bets $250
Lorpugo: calls $250
*** SHOW DOWN ***
Pooface77: shows [5d 6h] (a pair of Sevens)
Lorpugo: shows [Kd Jh] (a pair of Sevens - Ace+King kicker)
Lorpugo collected $847 from pot
*** SUMMARY ***
Total pot $892 | Rake $045
Board [3c Qs 7h 7c As]
Seat 1: Pooface77 (button) (small blind) showed [5d 6h] and lost with a pair of Sevens
Seat 2: Lorpugo (big blind) showed [Kd Jh] and won ($847) with a pair of Sevens


*********** # 147 **************
PokerStars Zoom Hand #236067561027: Hold'em No Limit ($025/$050) - 2022/05/11 18:49:26 ET
Table 'C Carinae' 2-max Seat #1 is the button
Seat 1: Lorpugo ($2450 in chips)
Seat 2: KrisMcC81 ($17263 in chips)
Lorpugo: posts small blind $025
KrisMcC81: posts big blind $050
*** HOLE CARDS ***
Dealt to Lorpugo [Jh 2h]
Lorpugo: raises $050 to $1
KrisMcC81: folds
Uncalled bet ($050) returned to Lorpugo
Lorpugo collected $1 from pot
Lorpugo: doesn't show hand
KrisMcC81 is disconnected
*** SUMMARY ***
Total pot $1 | Rake $0
Seat 1: Lorpugo (button) (small blind) collected ($1)
Seat 2: KrisMcC81 (big blind) folded before Flop


*********** # 148 **************
PokerStars Zoom Hand #236067558732: Hold'em No Limit ($025/$050) - 2022/05/11 18:49:19 ET
Table 'C Carinae' 2-max Seat #1 is the button
Seat 1: yazshuai ($13361 in chips)
Seat 2: Lorpugo ($25 in chips)
yazshuai: posts small blind $025
Lorpugo: posts big blind $050
*** HOLE CARDS ***
Dealt to Lorpugo [4s 2h]
yazshuai: raises $1 to $150
Lorpugo: folds
Uncalled bet ($1) returned to yazshuai
yazshuai collected $1 from pot
yazshuai: doesn't show hand
*** SUMMARY ***
Total pot $1 | Rake $0
Seat 1: yazshuai (button) (small blind) collected ($1)
Seat 2: Lorpugo (big blind) folded before Flop


*********** # 149 **************
PokerStars Zoom Hand #236067533286: Hold'em No Limit ($025/$050) - 2022/05/11 18:47:59 ET
Table 'C Carinae' 2-max Seat #1 is the button
Seat 1: Lorpugo ($2738 in chips)
Seat 2: RemCavemin ($8524 in chips)
Lorpugo: posts small blind $025
RemCavemin: posts big blind $050
*** HOLE CARDS ***
Dealt to Lorpugo [Kc 8c]
Lorpugo: raises $075 to $125
RemCavemin: raises $275 to $4
Lorpugo: calls $275
*** FLOP *** [Js 4s 2s]
RemCavemin: checks
Lorpugo: checks
*** TURN *** [Js 4s 2s] [7c]
RemCavemin: bets $350
Lorpugo: raises $1988 to $2338 and is all-in
RemCavemin: calls $1988
*** RIVER *** [Js 4s 2s 7c] [Jc]
Lorpugo: prays
*** SHOW DOWN ***
RemCavemin: shows [Ks As] (a flush, Ace high)
Lorpugo: shows [Kc 8c] (a pair of Jacks)
RemCavemin collected $5382 from pot
*** SUMMARY ***
Total pot $5476 | Rake $094
Board [Js 4s 2s 7c Jc]
Seat 1: Lorpugo (button) (small blind) showed [Kc 8c] and lost with a pair of Jacks
Seat 2: RemCavemin (big blind) showed [Ks As] and won ($5382) with a flush, Ace high


*********** # 150 **************
PokerStars Zoom Hand #236067530490: Hold'em No Limit ($025/$050) - 2022/05/11 18:47:50 ET
Table 'C Carinae' 2-max Seat #1 is the button
Seat 1: Kepez ($5511 in chips)
Seat 2: Lorpugo ($2788 in chips)
Kepez: posts small blind $025
Lorpugo: posts big blind $050
*** HOLE CARDS ***
Dealt to Lorpugo [Ts 2h]
Kepez: raises $075 to $125
Lorpugo: folds
Uncalled bet ($075) returned to Kepez
Kepez collected $1 from pot
Kepez: doesn't show hand
*** SUMMARY ***
Total pot $1 | Rake $0
Seat 1: Kepez (button) (small blind) collected ($1)
Seat 2: Lorpugo (big blind) folded before Flop


*********** # 151 **************
PokerStars Zoom Hand #236067510975: Hold'em No Limit ($025/$050) - 2022/05/11 18:46:49 ET
Table 'C Carinae' 2-max Seat #1 is the button
Seat 1: Lorpugo ($25 in chips)
Seat 2: irishboy_112 ($4787 in chips)
Lorpugo: posts small blind $025
irishboy_112: posts big blind $050
*** HOLE CARDS ***
Dealt to Lorpugo [6h Ad]
Lorpugo: raises $050 to $1
irishboy_112: calls $050
*** FLOP *** [7c 6d Ah]
irishboy_112: checks
Lorpugo: bets $064
irishboy_112: calls $064
*** TURN *** [7c 6d Ah] [Ks]
irishboy_112: checks
Lorpugo: checks
*** RIVER *** [7c 6d Ah Ks] [4c]
irishboy_112: bets $156
Lorpugo: raises $344 to $5
irishboy_112: folds
Uncalled bet ($344) returned to Lorpugo
Lorpugo collected $608 from pot
Lorpugo: doesn't show hand
irishboy_112 is disconnected
*** SUMMARY ***
Total pot $640 | Rake $032
Board [7c 6d Ah Ks 4c]
Seat 1: Lorpugo (button) (small blind) collected ($608)
Seat 2: irishboy_112 (big blind) folded on the River


*********** # 152 **************
PokerStars Zoom Hand #236067503498: Hold'em No Limit ($025/$050) - 2022/05/11 18:46:25 ET
Table 'C Carinae' 2-max Seat #1 is the button
Seat 1: lukeylund ($13412 in chips)
Seat 2: Lorpugo ($1302 in chips)
lukeylund: posts small blind $025
Lorpugo: posts big blind $050
*** HOLE CARDS ***
Dealt to Lorpugo [Jc Qh]
lukeylund: raises $13362 to $13412 and is all-in
Lorpugo: calls $1252 and is all-in
Uncalled bet ($12110) returned to lukeylund
*** FLOP *** [Ts 9d Qs]
Lorpugo: prays
*** TURN *** [Ts 9d Qs] [5h]
Lorpugo: prays
*** RIVER *** [Ts 9d Qs 5h] [Ah]
Lorpugo: prays
*** SHOW DOWN ***
Lorpugo: shows [Jc Qh] (a pair of Queens)
lukeylund: shows [Qc Kh] (a pair of Queens - Ace+King kicker)
lukeylund collected $2529 from pot
*** SUMMARY ***
Total pot $2604 | Rake $075
Board [Ts 9d Qs 5h Ah]
Seat 1: lukeylund (button) (small blind) showed [Qc Kh] and won ($2529) with a pair of Queens
Seat 2: Lorpugo (big blind) showed [Jc Qh] and lost with a pair of Queens


*********** # 153 **************
PokerStars Zoom Hand #236067495804: Hold'em No Limit ($025/$050) - 2022/05/11 18:46:00 ET
Table 'C Carinae' 2-max Seat #1 is the button
Seat 1: Lorpugo ($1506 in chips)
Seat 2: lukeylund ($13228 in chips)
Lorpugo: posts small blind $025
lukeylund: posts big blind $050
*** HOLE CARDS ***
Dealt to Lorpugo [7s 9h]
Lorpugo: raises $075 to $125
lukeylund: calls $075
*** FLOP *** [4c 2d Qs]
lukeylund: checks
Lorpugo: checks
*** TURN *** [4c 2d Qs] [8c]
lukeylund: checks
Lorpugo: checks
*** RIVER *** [4c 2d Qs 8c] [Ah]
lukeylund: checks
Lorpugo: bets $079
lukeylund: calls $079
*** SHOW DOWN ***
Lorpugo: shows [7s 9h] (high card Ace)
lukeylund: shows [8s Ts] (a pair of Eights)
lukeylund collected $388 from pot
*** SUMMARY ***
Total pot $408 | Rake $020
Board [4c 2d Qs 8c Ah]
Seat 1: Lorpugo (button) (small blind) showed [7s 9h] and lost with high card Ace
Seat 2: lukeylund (big blind) showed [8s Ts] and won ($388) with a pair of Eights


*********** # 154 **************
PokerStars Zoom Hand #236067493161: Hold'em No Limit ($025/$050) - 2022/05/11 18:45:52 ET
Table 'C Carinae' 2-max Seat #1 is the button
Seat 1: DzemAs ($4975 in chips)
Seat 2: Lorpugo ($1556 in chips)
DzemAs: posts small blind $025
Lorpugo: posts big blind $050
*** HOLE CARDS ***
Dealt to Lorpugo [4d 2h]
DzemAs: raises $065 to $115
Lorpugo: folds
Uncalled bet ($065) returned to DzemAs
DzemAs collected $1 from pot
DzemAs: doesn't show hand
*** SUMMARY ***
Total pot $1 | Rake $0
Seat 1: DzemAs (button) (small blind) collected ($1)
Seat 2: Lorpugo (big blind) folded before Flop


*********** # 155 **************
PokerStars Zoom Hand #236067489874: Hold'em No Limit ($025/$050) - 2022/05/11 18:45:42 ET
Table 'C Carinae' 2-max Seat #1 is the button
Seat 1: Lorpugo ($1506 in chips)
Seat 2: DzemAs ($7347 in chips)
Lorpugo: posts small blind $025
DzemAs: posts big blind $050
*** HOLE CARDS ***
Dealt to Lorpugo [Ac 5d]
Lorpugo: raises $075 to $125
DzemAs: folds
Uncalled bet ($075) returned to Lorpugo
Lorpugo collected $1 from pot
Lorpugo: doesn't show hand
*** SUMMARY ***
Total pot $1 | Rake $0
Seat 1: Lorpugo (button) (small blind) collected ($1)
Seat 2: DzemAs (big blind) folded before Flop


*********** # 156 **************
PokerStars Zoom Hand #236067481926: Hold'em No Limit ($025/$050) - 2022/05/11 18:45:17 ET
Table 'C Carinae' 2-max Seat #1 is the button
Seat 1: Kodeldowski ($7589 in chips)
Seat 2: Lorpugo ($1812 in chips)
Kodeldowski: posts small blind $025
Lorpugo: posts big blind $050
*** HOLE CARDS ***
Dealt to Lorpugo [3h 3d]
Kodeldowski: raises $075 to $125
Lorpugo: calls $075
*** FLOP *** [4d 7c 9s]
Lorpugo: checks
Kodeldowski: bets $181
Lorpugo: calls $181
*** TURN *** [4d 7c 9s] [2h]
Lorpugo: checks
Kodeldowski: bets $442
Lorpugo: folds
Uncalled bet ($442) returned to Kodeldowski
Kodeldowski collected $573 from pot
Kodeldowski: doesn't show hand
*** SUMMARY ***
Total pot $612 | Rake $039
Board [4d 7c 9s 2h]
Seat 1: Kodeldowski (button) (small blind) collected ($573)
Seat 2: Lorpugo (big blind) folded on the Turn


*********** # 157 **************
PokerStars Zoom Hand #236067480336: Hold'em No Limit ($025/$050) - 2022/05/11 18:45:12 ET
Table 'C Carinae' 2-max Seat #1 is the button
Seat 1: Lorpugo ($1837 in chips)
Seat 2: Always over EV ($5896 in chips)
Lorpugo: posts small blind $025
Always over EV: posts big blind $050
*** HOLE CARDS ***
Dealt to Lorpugo [Jh 2d]
Lorpugo: folds
Uncalled bet ($025) returned to Always over EV
Always over EV collected $050 from pot
Always over EV: doesn't show hand
*** SUMMARY ***
Total pot $050 | Rake $0
Seat 1: Lorpugo (button) (small blind) folded before Flop
Seat 2: Always over EV (big blind) collected ($050)


*********** # 158 **************
PokerStars Zoom Hand #236067467472: Hold'em No Limit ($025/$050) - 2022/05/11 18:44:52 ET
Table 'C Carinae' 2-max Seat #1 is the button
Seat 1: Kodeldowski ($7649 in chips)
Seat 2: Lorpugo ($1844 in chips)
Kodeldowski: posts small blind $025
Lorpugo: posts big blind $050
*** HOLE CARDS ***
Dealt to Lorpugo [7c 6h]
Kodeldowski: raises $050 to $1
Lorpugo: calls $050
*** FLOP *** [6s Jc As]
Lorpugo: checks
Kodeldowski: bets $050
Lorpugo: calls $050
*** TURN *** [6s Jc As] [Ks]
Lorpugo: checks
Kodeldowski: checks
*** RIVER *** [6s Jc As Ks] [Jh]
Lorpugo: checks
Kodeldowski: checks
*** SHOW DOWN ***
Lorpugo: shows [7c 6h] (two pair, Jacks and Sixes)
Kodeldowski: shows [8c 6d] (two pair, Jacks and Sixes)
Lorpugo collected $143 from pot
Kodeldowski collected $140 from pot
*** SUMMARY ***
Total pot $3 | Rake $017
Board [6s Jc As Ks Jh]
Seat 1: Kodeldowski (button) (small blind) showed [8c 6d] and won ($140) with two pair, Jacks and Sixes
Seat 2: Lorpugo (big blind) showed [7c 6h] and won ($143) with two pair, Jacks and Sixes


*********** # 159 **************
PokerStars Zoom Hand #236067460670: Hold'em No Limit ($025/$050) - 2022/05/11 18:44:31 ET
Table 'C Carinae' 2-max Seat #1 is the button
Seat 1: Lorpugo ($2294 in chips)
Seat 2: Kodeldowski ($7255 in chips)
Lorpugo: posts small blind $025
Kodeldowski: posts big blind $050
*** HOLE CARDS ***
Dealt to Lorpugo [Th 8d]
Lorpugo: raises $065 to $115
Kodeldowski: raises $335 to $450
Lorpugo: calls $335
*** FLOP *** [Ad 9s 4s]
Kodeldowski: bets $325
Lorpugo: folds
Uncalled bet ($325) returned to Kodeldowski
Kodeldowski collected $844 from pot
Kodeldowski: doesn't show hand
*** SUMMARY ***
Total pot $9 | Rake $056
Board [Ad 9s 4s]
Seat 1: Lorpugo (button) (small blind) folded on the Flop
Seat 2: Kodeldowski (big blind) collected ($844)


*********** # 160 **************
PokerStars Zoom Hand #236067440683: Hold'em No Limit ($025/$050) - 2022/05/11 18:43:29 ET
Table 'C Carinae' 2-max Seat #1 is the button
Seat 1: CashOnly96 ($5383 in chips)
Seat 2: Lorpugo ($1782 in chips)
CashOnly96: posts small blind $025
Lorpugo: posts big blind $050
*** HOLE CARDS ***
Dealt to Lorpugo [Jh Ac]
CashOnly96: raises $062 to $112
Lorpugo: raises $238 to $350
CashOnly96: calls $238
*** FLOP *** [Qd Ah 4d]
Lorpugo: bets $219
CashOnly96: calls $219
*** TURN *** [Qd Ah 4d] [5h]
Lorpugo: bets $450
CashOnly96: folds
Uncalled bet ($450) returned to Lorpugo
Lorpugo collected $1081 from pot
Lorpugo: doesn't show hand
CashOnly96 is disconnected
*** SUMMARY ***
Total pot $1138 | Rake $057
Board [Qd Ah 4d 5h]
Seat 1: CashOnly96 (button) (small blind) folded on the Turn
Seat 2: Lorpugo (big blind) collected ($1081)


*********** # 161 **************
PokerStars Zoom Hand #236067437763: Hold'em No Limit ($025/$050) - 2022/05/11 18:43:20 ET
Table 'C Carinae' 2-max Seat #1 is the button
Seat 1: Lorpugo ($1732 in chips)
Seat 2: DzemAs ($4888 in chips)
Lorpugo: posts small blind $025
DzemAs: posts big blind $050
*** HOLE CARDS ***
Dealt to Lorpugo [Ad 6s]
Lorpugo: raises $075 to $125
DzemAs: folds
Uncalled bet ($075) returned to Lorpugo
Lorpugo collected $1 from pot
Lorpugo: doesn't show hand
*** SUMMARY ***
Total pot $1 | Rake $0
Seat 1: Lorpugo (button) (small blind) collected ($1)
Seat 2: DzemAs (big blind) folded before Flop


*********** # 162 **************
PokerStars Zoom Hand #236067425016: Hold'em No Limit ($025/$050) - 2022/05/11 18:42:41 ET
Table 'C Carinae' 2-max Seat #1 is the button
Seat 1: Mich4elN ($26036 in chips)
Seat 2: Lorpugo ($1687 in chips)
Mich4elN: posts small blind $025
Lorpugo: posts big blind $050
*** HOLE CARDS ***
Dealt to Lorpugo [5d Jd]
Mich4elN: calls $025
Lorpugo: checks
*** FLOP *** [Kc 8s 3d]
Lorpugo: checks
Mich4elN: checks
*** TURN *** [Kc 8s 3d] [6h]
Lorpugo: checks
Mich4elN: checks
*** RIVER *** [Kc 8s 3d 6h] [9c]
Lorpugo: bets $150
Mich4elN: folds
Uncalled bet ($150) returned to Lorpugo
Lorpugo collected $095 from pot
Lorpugo: doesn't show hand
Mich4elN is disconnected
*** SUMMARY ***
Total pot $1 | Rake $005
Board [Kc 8s 3d 6h 9c]
Seat 1: Mich4elN (button) (small blind) folded on the River
Seat 2: Lorpugo (big blind) collected ($095)


*********** # 163 **************
PokerStars Zoom Hand #236067413574: Hold'em No Limit ($025/$050) - 2022/05/11 18:42:06 ET
Table 'C Carinae' 2-max Seat #1 is the button
Seat 1: Lorpugo ($25 in chips)
Seat 2: Mich4elN ($25298 in chips)
Lorpugo: posts small blind $025
Mich4elN: posts big blind $050
*** HOLE CARDS ***
Dealt to Lorpugo [4c Tc]
Lorpugo: raises $050 to $1
Mich4elN: calls $050
*** FLOP *** [Qc 5d 3d]
Mich4elN: checks
Lorpugo: bets $063
Mich4elN: calls $063
*** TURN *** [Qc 5d 3d] [7c]
Mich4elN: checks
Lorpugo: bets $2
Mich4elN: calls $2
*** RIVER *** [Qc 5d 3d 7c] [Qh]
Mich4elN: checks
Lorpugo: bets $450
Mich4elN: calls $450
*** SHOW DOWN ***
Lorpugo: shows [4c Tc] (a pair of Queens)
Mich4elN: shows [6c 7s] (two pair, Queens and Sevens)
Mich4elN collected $1551 from pot
*** SUMMARY ***
Total pot $1626 | Rake $075
Board [Qc 5d 3d 7c Qh]
Seat 1: Lorpugo (button) (small blind) showed [4c Tc] and lost with a pair of Queens
Seat 2: Mich4elN (big blind) showed [6c 7s] and won ($1551) with two pair, Queens and Sevens


*********** # 164 **************
PokerStars Zoom Hand #236067387607: Hold'em No Limit ($025/$050) - 2022/05/11 18:41:07 ET
Table 'C Carinae' 2-max Seat #1 is the button
Seat 1: ZenMisery ($5303 in chips)
Seat 2: Lorpugo ($25 in chips)
ZenMisery: posts small blind $025
Lorpugo: posts big blind $050
*** HOLE CARDS ***
Dealt to Lorpugo [Tc 4c]
ZenMisery: raises $075 to $125
Lorpugo: calls $075
*** FLOP *** [Kc Kh 9c]
Lorpugo: checks
ZenMisery: bets $075
Lorpugo: raises $128 to $203
ZenMisery: calls $128
*** TURN *** [Kc Kh 9c] [8d]
Lorpugo: bets $312
ZenMisery: raises $438 to $750
Lorpugo: calls $438
*** RIVER *** [Kc Kh 9c 8d] [5d]
Lorpugo: bets $1422 and is all-in
ZenMisery: calls $1422
*** SHOW DOWN ***
Lorpugo: shows [Tc 4c] (a pair of Kings)
ZenMisery: shows [Kd Ad] (three of a kind, Kings)
Lorpugo: prays
ZenMisery collected $4925 from pot
*** SUMMARY ***
Total pot $50 | Rake $075
Board [Kc Kh 9c 8d 5d]
Seat 1: ZenMisery (button) (small blind) showed [Kd Ad] and won ($4925) with three of a kind, Kings
Seat 2: Lorpugo (big blind) showed [Tc 4c] and lost with a pair of Kings


*********** # 165 **************
PokerStars Zoom Hand #236067369828: Hold'em No Limit ($025/$050) - 2022/05/11 18:40:13 ET
Table 'C Carinae' 2-max Seat #1 is the button
Seat 1: Lorpugo ($3450 in chips)
Seat 2: Kodeldowski ($50 in chips)
Lorpugo: posts small blind $025
Kodeldowski: posts big blind $050
*** HOLE CARDS ***
Dealt to Lorpugo [Ks 9h]
Lorpugo: raises $060 to $110
Kodeldowski: calls $060
*** FLOP *** [Ad 3h 5s]
Kodeldowski: checks
Lorpugo: bets $069
Kodeldowski: calls $069
*** TURN *** [Ad 3h 5s] [3s]
Kodeldowski: checks
Lorpugo: bets $105
Kodeldowski: raises $418 to $523
Lorpugo: folds
Uncalled bet ($418) returned to Kodeldowski
Kodeldowski collected $533 from pot
Kodeldowski: doesn't show hand
*** SUMMARY ***
Total pot $568 | Rake $035
Board [Ad 3h 5s 3s]
Seat 1: Lorpugo (button) (small blind) folded on the Turn
Seat 2: Kodeldowski (big blind) collected ($533)


*********** # 166 **************
PokerStars Zoom Hand #236067367207: Hold'em No Limit ($025/$050) - 2022/05/11 18:40:05 ET
Table 'C Carinae' 2-max Seat #1 is the button
Seat 1: Kodeldowski ($50 in chips)
Seat 2: Lorpugo ($3425 in chips)
Kodeldowski: posts small blind $025
Lorpugo: posts big blind $050
*** HOLE CARDS ***
Dealt to Lorpugo [Kd 5s]
Kodeldowski: folds
Uncalled bet ($025) returned to Lorpugo
Lorpugo collected $050 from pot
Lorpugo: doesn't show hand
*** SUMMARY ***
Total pot $050 | Rake $0
Seat 1: Kodeldowski (button) (small blind) folded before Flop
Seat 2: Lorpugo (big blind) collected ($050)


*********** # 167 **************
PokerStars Zoom Hand #236067352302: Hold'em No Limit ($025/$050) - 2022/05/11 18:39:20 ET
Table 'C Carinae' 2-max Seat #1 is the button
Seat 1: Lorpugo ($3024 in chips)
Seat 2: Kodeldowski ($5330 in chips)
Lorpugo: posts small blind $025
Kodeldowski: posts big blind $050
*** HOLE CARDS ***
Dealt to Lorpugo [Qh 4d]
Lorpugo: raises $050 to $1
Kodeldowski: calls $050
*** FLOP *** [Qc 3d Qs]
Kodeldowski: checks
Lorpugo: bets $095
Kodeldowski: calls $095
*** TURN *** [Qc 3d Qs] [Kd]
Kodeldowski: checks
Lorpugo: checks
*** RIVER *** [Qc 3d Qs Kd] [Ad]
Kodeldowski: checks
Lorpugo: bets $250
Kodeldowski: calls $250
*** SHOW DOWN ***
Lorpugo: shows [Qh 4d] (three of a kind, Queens)
Kodeldowski: mucks hand
Lorpugo collected $846 from pot
*** SUMMARY ***
Total pot $890 | Rake $044
Board [Qc 3d Qs Kd Ad]
Seat 1: Lorpugo (button) (small blind) showed [Qh 4d] and won ($846) with three of a kind, Queens
Seat 2: Kodeldowski (big blind) mucked [Ah 3s]


*********** # 168 **************
PokerStars Zoom Hand #236067338448: Hold'em No Limit ($025/$050) - 2022/05/11 18:38:38 ET
Table 'C Carinae' 2-max Seat #1 is the button
Seat 1: RemCavemin ($4889 in chips)
Seat 2: Lorpugo ($2831 in chips)
RemCavemin: posts small blind $025
Lorpugo: posts big blind $050
*** HOLE CARDS ***
Dealt to Lorpugo [Jd As]
RemCavemin: raises $065 to $115
Lorpugo: calls $065
*** FLOP *** [Kh Ac Jh]
Lorpugo: bets $050
RemCavemin: calls $050
*** TURN *** [Kh Ac Jh] [2c]
Lorpugo: bets $050
RemCavemin: calls $050
*** RIVER *** [Kh Ac Jh 2c] [7s]
Lorpugo: bets $450
RemCavemin: folds
Uncalled bet ($450) returned to Lorpugo
Lorpugo collected $408 from pot
Lorpugo: doesn't show hand
*** SUMMARY ***
Total pot $430 | Rake $022
Board [Kh Ac Jh 2c 7s]
Seat 1: RemCavemin (button) (small blind) folded on the River
Seat 2: Lorpugo (big blind) collected ($408)


*********** # 169 **************
PokerStars Zoom Hand #236067331867: Hold'em No Limit ($025/$050) - 2022/05/11 18:38:17 ET
Table 'C Carinae' 2-max Seat #1 is the button
Seat 1: Lorpugo ($2781 in chips)
Seat 2: jamesa261 ($4934 in chips)
Lorpugo: posts small blind $025
jamesa261: posts big blind $050
*** HOLE CARDS ***
Dealt to Lorpugo [3c As]
Lorpugo: raises $060 to $110
jamesa261: folds
Uncalled bet ($060) returned to Lorpugo
Lorpugo collected $1 from pot
Lorpugo: doesn't show hand
jamesa261 is disconnected
*** SUMMARY ***
Total pot $1 | Rake $0
Seat 1: Lorpugo (button) (small blind) collected ($1)
Seat 2: jamesa261 (big blind) folded before Flop


*********** # 170 **************
PokerStars Zoom Hand #236067322316: Hold'em No Limit ($025/$050) - 2022/05/11 18:37:48 ET
Table 'C Carinae' 2-max Seat #1 is the button
Seat 1: [chr1StaR] ($3701 in chips)
Seat 2: Lorpugo ($2881 in chips)
[chr1StaR]: posts small blind $025
Lorpugo: posts big blind $050
*** HOLE CARDS ***
Dealt to Lorpugo [6h 4c]
[chr1StaR]: raises $050 to $1
Lorpugo: calls $050
*** FLOP *** [9s Kd Jc]
Lorpugo: checks
[chr1StaR]: bets $068
Lorpugo: folds
Uncalled bet ($068) returned to [chr1StaR]
[chr1StaR] collected $188 from pot
[chr1StaR]: doesn't show hand
*** SUMMARY ***
Total pot $2 | Rake $012
Board [9s Kd Jc]
Seat 1: [chr1StaR] (button) (small blind) collected ($188)
Seat 2: Lorpugo (big blind) folded on the Flop


*********** # 171 **************
PokerStars Zoom Hand #236067318624: Hold'em No Limit ($025/$050) - 2022/05/11 18:37:37 ET
Table 'C Carinae' 2-max Seat #1 is the button
Seat 1: Lorpugo ($2831 in chips)
Seat 2: DzemAs ($5205 in chips)
Lorpugo: posts small blind $025
DzemAs: posts big blind $050
*** HOLE CARDS ***
Dealt to Lorpugo [8c 6h]
Lorpugo: raises $075 to $125
DzemAs: folds
Uncalled bet ($075) returned to Lorpugo
Lorpugo collected $1 from pot
Lorpugo: doesn't show hand
*** SUMMARY ***
Total pot $1 | Rake $0
Seat 1: Lorpugo (button) (small blind) collected ($1)
Seat 2: DzemAs (big blind) folded before Flop


*********** # 172 **************
PokerStars Zoom Hand #236067311033: Hold'em No Limit ($025/$050) - 2022/05/11 18:37:14 ET
Table 'C Carinae' 2-max Seat #1 is the button
Seat 1: irishboy_112 ($661 in chips)
Seat 2: Lorpugo ($2786 in chips)
irishboy_112: posts small blind $025
Lorpugo: posts big blind $050
*** HOLE CARDS ***
Dealt to Lorpugo [Jh 3h]
irishboy_112: calls $025
Lorpugo: checks
*** FLOP *** [Ad Jd Kc]
Lorpugo: checks
irishboy_112: checks
*** TURN *** [Ad Jd Kc] [5c]
Lorpugo: checks
irishboy_112: checks
*** RIVER *** [Ad Jd Kc 5c] [5s]
Lorpugo: checks
irishboy_112: checks
*** SHOW DOWN ***
Lorpugo: shows [Jh 3h] (two pair, Jacks and Fives)
irishboy_112: mucks hand
Lorpugo collected $095 from pot
*** SUMMARY ***
Total pot $1 | Rake $005
Board [Ad Jd Kc 5c 5s]
Seat 1: irishboy_112 (button) (small blind) mucked [Qh 2h]
Seat 2: Lorpugo (big blind) showed [Jh 3h] and won ($095) with two pair, Jacks and Fives


*********** # 173 **************
PokerStars Zoom Hand #236067309028: Hold'em No Limit ($025/$050) - 2022/05/11 18:37:08 ET
Table 'C Carinae' 2-max Seat #1 is the button
Seat 1: Lorpugo ($2811 in chips)
Seat 2: lukeylund ($13686 in chips)
Lorpugo: posts small blind $025
lukeylund: posts big blind $050
*** HOLE CARDS ***
Dealt to Lorpugo [3h Js]
Lorpugo: folds
Uncalled bet ($025) returned to lukeylund
lukeylund collected $050 from pot
lukeylund: doesn't show hand
*** SUMMARY ***
Total pot $050 | Rake $0
Seat 1: Lorpugo (button) (small blind) folded before Flop
Seat 2: lukeylund (big blind) collected ($050)


*********** # 174 **************
PokerStars Zoom Hand #236067300021: Hold'em No Limit ($025/$050) - 2022/05/11 18:36:41 ET
Table 'C Carinae' 2-max Seat #1 is the button
Seat 1: DzemAs ($5877 in chips)
Seat 2: Lorpugo ($25 in chips)
DzemAs: posts small blind $025
Lorpugo: posts big blind $050
*** HOLE CARDS ***
Dealt to Lorpugo [6d Kc]
DzemAs: raises $065 to $115
Lorpugo: raises $230 to $345
DzemAs: calls $230
*** FLOP *** [4h Qd 3s]
Lorpugo: checks
DzemAs: checks
*** TURN *** [4h Qd 3s] [3c]
Lorpugo: bets $460
DzemAs: folds
Uncalled bet ($460) returned to Lorpugo
Lorpugo collected $656 from pot
Lorpugo: doesn't show hand
*** SUMMARY ***
Total pot $690 | Rake $034
Board [4h Qd 3s 3c]
Seat 1: DzemAs (button) (small blind) folded on the Turn
Seat 2: Lorpugo (big blind) collected ($656)


*********** # 175 **************
PokerStars Zoom Hand #236067289687: Hold'em No Limit ($025/$050) - 2022/05/11 18:36:10 ET
Table 'C Carinae' 2-max Seat #1 is the button
Seat 1: Lorpugo ($3498 in chips)
Seat 2: kutiman ($9771 in chips)
Lorpugo: posts small blind $025
kutiman: posts big blind $050
*** HOLE CARDS ***
Dealt to Lorpugo [Th 7c]
Lorpugo: raises $050 to $1
kutiman: folds
Uncalled bet ($050) returned to Lorpugo
Lorpugo collected $1 from pot
Lorpugo: doesn't show hand
*** SUMMARY ***
Total pot $1 | Rake $0
Seat 1: Lorpugo (button) (small blind) collected ($1)
Seat 2: kutiman (big blind) folded before Flop


*********** # 176 **************
PokerStars Zoom Hand #236067277320: Hold'em No Limit ($025/$050) - 2022/05/11 18:35:33 ET
Table 'C Carinae' 2-max Seat #1 is the button
Seat 1: Lorpugo ($3395 in chips)
Seat 2: Nbg453 ($12861 in chips)
Lorpugo: posts small blind $025
Nbg453: posts big blind $050
*** HOLE CARDS ***
Dealt to Lorpugo [9s Ah]
Lorpugo: raises $065 to $115
Nbg453: calls $065
*** FLOP *** [Ks Ts 3c]
Nbg453: checks
Lorpugo: checks
*** TURN *** [Ks Ts 3c] [4s]
Nbg453: checks
Lorpugo: bets $072
Nbg453: folds
Uncalled bet ($072) returned to Lorpugo
Lorpugo collected $218 from pot
Lorpugo: doesn't show hand
Nbg453 is disconnected
*** SUMMARY ***
Total pot $230 | Rake $012
Board [Ks Ts 3c 4s]
Seat 1: Lorpugo (button) (small blind) collected ($218)
Seat 2: Nbg453 (big blind) folded on the Turn


*********** # 177 **************
PokerStars Zoom Hand #236067275303: Hold'em No Limit ($025/$050) - 2022/05/11 18:35:27 ET
Table 'C Carinae' 2-max Seat #1 is the button
Seat 1: Kodeldowski ($6172 in chips)
Seat 2: Lorpugo ($3370 in chips)
Kodeldowski: posts small blind $025
Lorpugo: posts big blind $050
*** HOLE CARDS ***
Dealt to Lorpugo [Kd Tc]
Kodeldowski: folds
Uncalled bet ($025) returned to Lorpugo
Lorpugo collected $050 from pot
Lorpugo: doesn't show hand
*** SUMMARY ***
Total pot $050 | Rake $0
Seat 1: Kodeldowski (button) (small blind) folded before Flop
Seat 2: Lorpugo (big blind) collected ($050)


*********** # 178 **************
PokerStars Zoom Hand #236067252929: Hold'em No Limit ($025/$050) - 2022/05/11 18:34:19 ET
Table 'C Carinae' 2-max Seat #1 is the button
Seat 1: Lorpugo ($3257 in chips)
Seat 2: Kepez ($13780 in chips)
Lorpugo: posts small blind $025
Kepez: posts big blind $050
*** HOLE CARDS ***
Dealt to Lorpugo [6d Td]
Lorpugo: raises $075 to $125
Kepez: calls $075
*** FLOP *** [7s Qs 5s]
Kepez: checks
Lorpugo: checks
*** TURN *** [7s Qs 5s] [Qc]
Kepez: checks
Lorpugo: bets $166
Kepez: folds
Uncalled bet ($166) returned to Lorpugo
Lorpugo collected $238 from pot
Lorpugo: doesn't show hand
*** SUMMARY ***
Total pot $250 | Rake $012
Board [7s Qs 5s Qc]
Seat 1: Lorpugo (button) (small blind) collected ($238)
Seat 2: Kepez (big blind) folded on the Turn


*********** # 179 **************
PokerStars Zoom Hand #236067244635: Hold'em No Limit ($025/$050) - 2022/05/11 18:33:54 ET
Table 'C Carinae' 2-max Seat #1 is the button
Seat 1: lukeylund ($12971 in chips)
Seat 2: Lorpugo ($3122 in chips)
lukeylund: posts small blind $025
Lorpugo: posts big blind $050
*** HOLE CARDS ***
Dealt to Lorpugo [Jh Kd]
lukeylund: calls $025
Lorpugo: raises $1 to $150
lukeylund: calls $1
*** FLOP *** [9h 9c 2c]
Lorpugo: bets $088
lukeylund: folds
Uncalled bet ($088) returned to Lorpugo
Lorpugo collected $285 from pot
Lorpugo: doesn't show hand
lukeylund is disconnected
*** SUMMARY ***
Total pot $3 | Rake $015
Board [9h 9c 2c]
Seat 1: lukeylund (button) (small blind) folded on the Flop
Seat 2: Lorpugo (big blind) collected ($285)


*********** # 180 **************
PokerStars Zoom Hand #236067241544: Hold'em No Limit ($025/$050) - 2022/05/11 18:33:45 ET
Table 'C Carinae' 2-max Seat #1 is the button
Seat 1: Lorpugo ($3147 in chips)
Seat 2: Kepez ($13617 in chips)
Lorpugo: posts small blind $025
Kepez: posts big blind $050
*** HOLE CARDS ***
Dealt to Lorpugo [4c 9s]
Lorpugo: folds
Uncalled bet ($025) returned to Kepez
Kepez collected $050 from pot
Kepez: doesn't show hand
*** SUMMARY ***
Total pot $050 | Rake $0
Seat 1: Lorpugo (button) (small blind) folded before Flop
Seat 2: Kepez (big blind) collected ($050)


*********** # 181 **************
PokerStars Zoom Hand #236067239556: Hold'em No Limit ($025/$050) - 2022/05/11 18:33:39 ET
Table 'C Carinae' 2-max Seat #1 is the button
Seat 1: [chr1StaR] ($3262 in chips)
Seat 2: Lorpugo ($3197 in chips)
[chr1StaR]: posts small blind $025
Lorpugo: posts big blind $050
*** HOLE CARDS ***
Dealt to Lorpugo [8s 2d]
[chr1StaR]: raises $050 to $1
Lorpugo: folds
Uncalled bet ($050) returned to [chr1StaR]
[chr1StaR] collected $1 from pot
[chr1StaR]: doesn't show hand
*** SUMMARY ***
Total pot $1 | Rake $0
Seat 1: [chr1StaR] (button) (small blind) collected ($1)
Seat 2: Lorpugo (big blind) folded before Flop


*********** # 182 **************
PokerStars Zoom Hand #236067237463: Hold'em No Limit ($025/$050) - 2022/05/11 18:33:33 ET
Table 'C Carinae' 2-max Seat #1 is the button
Seat 1: Lorpugo ($3222 in chips)
Seat 2: autoactor ($3528 in chips)
Lorpugo: posts small blind $025
autoactor: posts big blind $050
*** HOLE CARDS ***
Dealt to Lorpugo [5s Jc]
Lorpugo: folds
Uncalled bet ($025) returned to autoactor
autoactor collected $050 from pot
autoactor: doesn't show hand
*** SUMMARY ***
Total pot $050 | Rake $0
Seat 1: Lorpugo (button) (small blind) folded before Flop
Seat 2: autoactor (big blind) collected ($050)


*********** # 183 **************
PokerStars Zoom Hand #236067232869: Hold'em No Limit ($025/$050) - 2022/05/11 18:33:19 ET
Table 'C Carinae' 2-max Seat #1 is the button
Seat 1: Skala13220 ($9158 in chips)
Seat 2: Lorpugo ($3272 in chips)
Skala13220: posts small blind $025
Lorpugo: posts big blind $050
*** HOLE CARDS ***
Dealt to Lorpugo [4s 2c]
Skala13220: raises $1 to $150
Lorpugo: folds
Uncalled bet ($1) returned to Skala13220
Skala13220 collected $1 from pot
Skala13220: doesn't show hand
*** SUMMARY ***
Total pot $1 | Rake $0
Seat 1: Skala13220 (button) (small blind) collected ($1)
Seat 2: Lorpugo (big blind) folded before Flop


*********** # 184 **************
PokerStars Zoom Hand #236067229702: Hold'em No Limit ($025/$050) - 2022/05/11 18:33:10 ET
Table 'C Carinae' 2-max Seat #1 is the button
Seat 1: Lorpugo ($3222 in chips)
Seat 2: lukeylund ($12816 in chips)
Lorpugo: posts small blind $025
lukeylund: posts big blind $050
*** HOLE CARDS ***
Dealt to Lorpugo [6c 8s]
Lorpugo: raises $050 to $1
lukeylund: folds
Uncalled bet ($050) returned to Lorpugo
Lorpugo collected $1 from pot
Lorpugo: doesn't show hand
lukeylund is disconnected
*** SUMMARY ***
Total pot $1 | Rake $0
Seat 1: Lorpugo (button) (small blind) collected ($1)
Seat 2: lukeylund (big blind) folded before Flop


*********** # 185 **************
PokerStars Zoom Hand #236067223120: Hold'em No Limit ($025/$050) - 2022/05/11 18:32:50 ET
Table 'C Carinae' 2-max Seat #1 is the button
Seat 1: Always over EV ($6206 in chips)
Seat 2: Lorpugo ($3177 in chips)
Always over EV: posts small blind $025
Lorpugo: posts big blind $050
*** HOLE CARDS ***
Dealt to Lorpugo [Kh 5c]
Always over EV: calls $025
Lorpugo: checks
*** FLOP *** [Jd Ad 3d]
Lorpugo: checks
Always over EV: checks
*** TURN *** [Jd Ad 3d] [8h]
Lorpugo: checks
Always over EV: checks
*** RIVER *** [Jd Ad 3d 8h] [2h]
Lorpugo: checks
Always over EV: checks
*** SHOW DOWN ***
Lorpugo: shows [Kh 5c] (high card Ace)
Always over EV: mucks hand
Lorpugo collected $095 from pot
*** SUMMARY ***
Total pot $1 | Rake $005
Board [Jd Ad 3d 8h 2h]
Seat 1: Always over EV (button) (small blind) mucked [Qc 4d]
Seat 2: Lorpugo (big blind) showed [Kh 5c] and won ($095) with high card Ace


*********** # 186 **************
PokerStars Zoom Hand #236067213112: Hold'em No Limit ($025/$050) - 2022/05/11 18:32:20 ET
Table 'C Carinae' 2-max Seat #1 is the button
Seat 1: Lorpugo ($2540 in chips)
Seat 2: irishboy_112 ($2466 in chips)
Lorpugo: posts small blind $025
irishboy_112: posts big blind $050
*** HOLE CARDS ***
Dealt to Lorpugo [9s Kd]
Lorpugo: raises $075 to $125
irishboy_112: calls $075
*** FLOP *** [Kc 4s Ac]
irishboy_112: bets $119
Lorpugo: calls $119
*** TURN *** [Kc 4s Ac] [Th]
irishboy_112: checks
Lorpugo: checks
*** RIVER *** [Kc 4s Ac Th] [Ks]
irishboy_112: bets $464
Lorpugo: raises $1832 to $2296 and is all-in
irishboy_112: folds
Uncalled bet ($1832) returned to Lorpugo
Lorpugo collected $1345 from pot
Lorpugo: doesn't show hand
irishboy_112 is disconnected
*** SUMMARY ***
Total pot $1416 | Rake $071
Board [Kc 4s Ac Th Ks]
Seat 1: Lorpugo (button) (small blind) collected ($1345)
Seat 2: irishboy_112 (big blind) folded on the River


*********** # 187 **************
PokerStars Zoom Hand #236067210732: Hold'em No Limit ($025/$050) - 2022/05/11 18:32:13 ET
Table 'C Carinae' 2-max Seat #1 is the button
Seat 1: RemCavemin ($8579 in chips)
Seat 2: Lorpugo ($2515 in chips)
RemCavemin: posts small blind $025
Lorpugo: posts big blind $050
*** HOLE CARDS ***
Dealt to Lorpugo [6c 5d]
RemCavemin: folds
Uncalled bet ($025) returned to Lorpugo
Lorpugo collected $050 from pot
Lorpugo: doesn't show hand
*** SUMMARY ***
Total pot $050 | Rake $0
Seat 1: RemCavemin (button) (small blind) folded before Flop
Seat 2: Lorpugo (big blind) collected ($050)


*********** # 188 **************
PokerStars Zoom Hand #236067207094: Hold'em No Limit ($025/$050) - 2022/05/11 18:32:02 ET
Table 'C Carinae' 2-max Seat #1 is the button
Seat 1: Lorpugo ($2565 in chips)
Seat 2: Always over EV ($6186 in chips)
Lorpugo: posts small blind $025
Always over EV: posts big blind $050
*** HOLE CARDS ***
Dealt to Lorpugo [8s 9s]
Lorpugo: calls $025
Always over EV: raises $6136 to $6186 and is all-in
Lorpugo: folds
Uncalled bet ($6136) returned to Always over EV
Always over EV collected $1 from pot
Always over EV: doesn't show hand
*** SUMMARY ***
Total pot $1 | Rake $0
Seat 1: Lorpugo (button) (small blind) folded before Flop
Seat 2: Always over EV (big blind) collected ($1)


*********** # 189 **************
PokerStars Zoom Hand #236067204803: Hold'em No Limit ($025/$050) - 2022/05/11 18:31:55 ET
Table 'C Carinae' 2-max Seat #1 is the button
Seat 1: RemCavemin ($5376 in chips)
Seat 2: Lorpugo ($2540 in chips)
RemCavemin: posts small blind $025
Lorpugo: posts big blind $050
*** HOLE CARDS ***
Dealt to Lorpugo [7d As]
RemCavemin: folds
Uncalled bet ($025) returned to Lorpugo
Lorpugo collected $050 from pot
Lorpugo: doesn't show hand
*** SUMMARY ***
Total pot $050 | Rake $0
Seat 1: RemCavemin (button) (small blind) folded before Flop
Seat 2: Lorpugo (big blind) collected ($050)


*********** # 190 **************
PokerStars Zoom Hand #236067196650: Hold'em No Limit ($025/$050) - 2022/05/11 18:31:31 ET
Table 'C Carinae' 2-max Seat #1 is the button
Seat 1: Lorpugo ($2450 in chips)
Seat 2: Nbg453 ($10901 in chips)
Lorpugo: posts small blind $025
Nbg453: posts big blind $050
*** HOLE CARDS ***
Dealt to Lorpugo [9c Ad]
Lorpugo: raises $050 to $1
Nbg453: calls $050
*** FLOP *** [Qd 7s As]
Nbg453: checks
Lorpugo: checks
*** TURN *** [Qd 7s As] [8d]
Nbg453: checks
Lorpugo: bets $133
Nbg453: folds
Uncalled bet ($133) returned to Lorpugo
Lorpugo collected $190 from pot
Lorpugo: doesn't show hand
Nbg453 is disconnected
*** SUMMARY ***
Total pot $2 | Rake $010
Board [Qd 7s As 8d]
Seat 1: Lorpugo (button) (small blind) collected ($190)
Seat 2: Nbg453 (big blind) folded on the Turn


*********** # 191 **************
PokerStars Zoom Hand #236067193931: Hold'em No Limit ($025/$050) - 2022/05/11 18:31:23 ET
Table 'C Carinae' 2-max Seat #1 is the button
Seat 1: Always over EV ($6061 in chips)
Seat 2: Lorpugo ($25 in chips)
Always over EV: posts small blind $025
Lorpugo: posts big blind $050
*** HOLE CARDS ***
Dealt to Lorpugo [9s 5h]
Always over EV: raises $6011 to $6061 and is all-in
Lorpugo: folds
Uncalled bet ($6011) returned to Always over EV
Always over EV collected $1 from pot
Always over EV: doesn't show hand
*** SUMMARY ***
Total pot $1 | Rake $0
Seat 1: Always over EV (button) (small blind) collected ($1)
Seat 2: Lorpugo (big blind) folded before Flop


*********** # 192 **************
PokerStars Zoom Hand #236067185509: Hold'em No Limit ($025/$050) - 2022/05/11 18:30:57 ET
Table 'C Carinae' 2-max Seat #1 is the button
Seat 1: Lorpugo ($3702 in chips)
Seat 2: yazshuai ($3916 in chips)
Lorpugo: posts small blind $025
yazshuai: posts big blind $050
*** HOLE CARDS ***
Dealt to Lorpugo [8d 7s]
Lorpugo: raises $050 to $1
yazshuai: folds
Uncalled bet ($050) returned to Lorpugo
Lorpugo collected $1 from pot
Lorpugo: doesn't show hand
yazshuai is disconnected
*** SUMMARY ***
Total pot $1 | Rake $0
Seat 1: Lorpugo (button) (small blind) collected ($1)
Seat 2: yazshuai (big blind) folded before Flop


*********** # 193 **************
PokerStars Zoom Hand #236067176300: Hold'em No Limit ($025/$050) - 2022/05/11 18:30:30 ET
Table 'C Carinae' 2-max Seat #1 is the button
Seat 1: Lorpugo ($3612 in chips)
Seat 2: irishboy_112 ($2271 in chips)
Lorpugo: posts small blind $025
irishboy_112: posts big blind $050
*** HOLE CARDS ***
Dealt to Lorpugo [Qc Jd]
Lorpugo: raises $050 to $1
irishboy_112: calls $050
*** FLOP *** [Ts 5d 4h]
irishboy_112: checks
Lorpugo: bets $063
irishboy_112: folds
Uncalled bet ($063) returned to Lorpugo
Lorpugo collected $190 from pot
Lorpugo: doesn't show hand
irishboy_112 is disconnected
*** SUMMARY ***
Total pot $2 | Rake $010
Board [Ts 5d 4h]
Seat 1: Lorpugo (button) (small blind) collected ($190)
Seat 2: irishboy_112 (big blind) folded on the Flop


*********** # 194 **************
PokerStars Zoom Hand #236067170330: Hold'em No Limit ($025/$050) - 2022/05/11 18:30:12 ET
Table 'C Carinae' 2-max Seat #1 is the button
Seat 1: Skala13220 ($8513 in chips)
Seat 2: Lorpugo ($3336 in chips)
Skala13220: posts small blind $025
Lorpugo: posts big blind $050
*** HOLE CARDS ***
Dealt to Lorpugo [Ad Kh]
Skala13220: raises $1 to $150
Lorpugo: calls $1
*** FLOP *** [As 4d Ah]
Lorpugo: checks
Skala13220: bets $157
Lorpugo: raises $157 to $314
Skala13220: folds
Uncalled bet ($157) returned to Lorpugo
Lorpugo collected $583 from pot
Lorpugo: doesn't show hand
*** SUMMARY ***
Total pot $614 | Rake $031
Board [As 4d Ah]
Seat 1: Skala13220 (button) (small blind) folded on the Flop
Seat 2: Lorpugo (big blind) collected ($583)


*********** # 195 **************
PokerStars Zoom Hand #236067167270: Hold'em No Limit ($025/$050) - 2022/05/11 18:30:02 ET
Table 'C Carinae' 2-max Seat #1 is the button
Seat 1: marco693230 ($5959 in chips)
Seat 2: Lorpugo ($3311 in chips)
marco693230: posts small blind $025
Lorpugo: posts big blind $050
*** HOLE CARDS ***
Dealt to Lorpugo [9d 4d]
marco693230: folds
Uncalled bet ($025) returned to Lorpugo
Lorpugo collected $050 from pot
Lorpugo: doesn't show hand
*** SUMMARY ***
Total pot $050 | Rake $0
Seat 1: marco693230 (button) (small blind) folded before Flop
Seat 2: Lorpugo (big blind) collected ($050)


*********** # 196 **************
PokerStars Zoom Hand #236067165141: Hold'em No Limit ($025/$050) - 2022/05/11 18:29:56 ET
Table 'C Carinae' 2-max Seat #1 is the button
Seat 1: Lorpugo ($3336 in chips)
Seat 2: Mich4elN ($20494 in chips)
Lorpugo: posts small blind $025
Mich4elN: posts big blind $050
*** HOLE CARDS ***
Dealt to Lorpugo [9h 5d]
Lorpugo: folds
Uncalled bet ($025) returned to Mich4elN
Mich4elN collected $050 from pot
Mich4elN: doesn't show hand
*** SUMMARY ***
Total pot $050 | Rake $0
Seat 1: Lorpugo (button) (small blind) folded before Flop
Seat 2: Mich4elN (big blind) collected ($050)


*********** # 197 **************
PokerStars Zoom Hand #236067156170: Hold'em No Limit ($025/$050) - 2022/05/11 18:29:29 ET
Table 'C Carinae' 2-max Seat #1 is the button
Seat 1: Skala13220 ($8988 in chips)
Seat 2: Lorpugo ($2931 in chips)
Skala13220: posts small blind $025
Lorpugo: posts big blind $050
*** HOLE CARDS ***
Dealt to Lorpugo [Jd Js]
Skala13220: raises $1 to $150
Lorpugo: raises $3 to $450
Skala13220: calls $3
*** FLOP *** [Ah 4h 3c]
Lorpugo: checks
Skala13220: checks
*** TURN *** [Ah 4h 3c] [9d]
Lorpugo: checks
Skala13220: checks
*** RIVER *** [Ah 4h 3c 9d] [Tc]
Lorpugo: bets $428
Skala13220: folds
Uncalled bet ($428) returned to Lorpugo
Lorpugo collected $855 from pot
Lorpugo: doesn't show hand
*** SUMMARY ***
Total pot $9 | Rake $045
Board [Ah 4h 3c 9d Tc]
Seat 1: Skala13220 (button) (small blind) folded on the River
Seat 2: Lorpugo (big blind) collected ($855)


*********** # 198 **************
PokerStars Zoom Hand #236067131818: Hold'em No Limit ($025/$050) - 2022/05/11 18:28:22 ET
Table 'C Carinae' 2-max Seat #1 is the button
Seat 1: Lorpugo ($2528 in chips)
Seat 2: marco693230 ($50 in chips)
Lorpugo: posts small blind $025
marco693230: posts big blind $050
*** HOLE CARDS ***
Dealt to Lorpugo [Ah Tc]
Dealt to marco693230 [9s 4s]
Lorpugo: calls $025
marco693230: checks
*** FLOP *** [7s As Jh]
marco693230: checks
Lorpugo: bets $050
marco693230: raises $098 to $148
Lorpugo: calls $098
*** TURN *** [7s As Jh] [7h]
marco693230: checks
Lorpugo: checks
*** RIVER *** [7s As Jh 7h] [8d]
marco693230: bets $250
Lorpugo: calls $250
*** SHOW DOWN ***
marco693230: shows [9s 4s] (a pair of Sevens)
Lorpugo: shows [Ah Tc] (two pair, Aces and Sevens)
Lorpugo collected $851 from pot
*** SUMMARY ***
Total pot $896 | Rake $045
Board [7s As Jh 7h 8d]
Seat 1: Lorpugo (button) (small blind) showed [Ah Tc] and won ($851) with two pair, Aces and Sevens
Seat 2: marco693230 (big blind) showed [9s 4s] and lost with a pair of Sevens


*********** # 199 **************
PokerStars Zoom Hand #236067128184: Hold'em No Limit ($025/$050) - 2022/05/11 18:28:11 ET
Table 'C Carinae' 2-max Seat #1 is the button
Seat 1: marco693230 ($50 in chips)
Seat 2: Lorpugo ($2503 in chips)
marco693230: posts small blind $025
Lorpugo: posts big blind $050
*** HOLE CARDS ***
Dealt to Lorpugo [2h 3h]
marco693230: folds
Uncalled bet ($025) returned to Lorpugo
Lorpugo collected $050 from pot
Lorpugo: doesn't show hand
*** SUMMARY ***
Total pot $050 | Rake $0
Seat 1: marco693230 (button) (small blind) folded before Flop
Seat 2: Lorpugo (big blind) collected ($050)


*********** # 200 **************
PokerStars Zoom Hand #236067124146: Hold'em No Limit ($025/$050) - 2022/05/11 18:27:59 ET
Table 'C Carinae' 2-max Seat #1 is the button
Seat 1: Lorpugo ($2453 in chips)
Seat 2: lukeylund ($14244 in chips)
Lorpugo: posts small blind $025
lukeylund: posts big blind $050
*** HOLE CARDS ***
Dealt to Lorpugo [Qs 8s]
Lorpugo: raises $070 to $120
lukeylund: folds
Uncalled bet ($070) returned to Lorpugo
Lorpugo collected $1 from pot
Lorpugo: doesn't show hand
lukeylund is disconnected
*** SUMMARY ***
Total pot $1 | Rake $0
Seat 1: Lorpugo (button) (small blind) collected ($1)
Seat 2: lukeylund (big blind) folded before Flop