PokerStars Zoom Hand #236522748040:  Hold'em No Limit ($0.25/$0.50) - 2022/06/02 14:16:34 ET
Table 'C Carinae' 2-max Seat #1 is the button
Seat 1: friediii11 ($81.14 in chips) 
Seat 2: Lorpugo ($25 in chips) 
friediii11: posts small blind $0.25
Lorpugo: posts big blind $0.50
*** HOLE CARDS ***
Dealt to Lorpugo [Tc 6d]
friediii11: folds 
Uncalled bet ($0.25) returned to Lorpugo
Lorpugo collected $0.50 from pot
Lorpugo: doesn't show hand 
*** SUMMARY ***
Total pot $0.50 | Rake $0 
Seat 1: friediii11 (button) (small blind) folded before Flop
Seat 2: Lorpugo (big blind) collected ($0.50)



PokerStars Zoom Hand #236522749951:  Hold'em No Limit ($0.25/$0.50) - 2022/06/02 14:16:40 ET
Table 'C Carinae' 2-max Seat #1 is the button
Seat 1: Lorpugo ($25.25 in chips) 
Seat 2: Mtaneli ($145.48 in chips) 
Lorpugo: posts small blind $0.25
Mtaneli: posts big blind $0.50
*** HOLE CARDS ***
Dealt to Lorpugo [3h Ah]
Lorpugo: raises $0.60 to $1.10
Mtaneli: raises $2.15 to $3.25
Lorpugo: calls $2.15
*** FLOP *** [7h Qs 3s]
Mtaneli: bets $1.92
Lorpugo: raises $20.08 to $22 and is all-in
Mtaneli: folds 
Uncalled bet ($20.08) returned to Lorpugo
Lorpugo collected $9.82 from pot
Lorpugo: doesn't show hand 
*** SUMMARY ***
Total pot $10.34 | Rake $0.52 
Board [7h Qs 3s]
Seat 1: Lorpugo (button) (small blind) collected ($9.82)
Seat 2: Mtaneli (big blind) folded on the Flop



PokerStars Zoom Hand #236522759106:  Hold'em No Limit ($0.25/$0.50) - 2022/06/02 14:17:07 ET
Table 'C Carinae' 2-max Seat #1 is the button
Seat 1: DzemAs ($55.48 in chips) 
Seat 2: Lorpugo ($29.90 in chips) 
DzemAs: posts small blind $0.25
Lorpugo: posts big blind $0.50
*** HOLE CARDS ***
Dealt to Lorpugo [Qc 7d]
DzemAs: folds 
Uncalled bet ($0.25) returned to Lorpugo
Lorpugo collected $0.50 from pot
Lorpugo: doesn't show hand 
*** SUMMARY ***
Total pot $0.50 | Rake $0 
Seat 1: DzemAs (button) (small blind) folded before Flop
Seat 2: Lorpugo (big blind) collected ($0.50)



PokerStars Zoom Hand #236522760800:  Hold'em No Limit ($0.25/$0.50) - 2022/06/02 14:17:12 ET
Table 'C Carinae' 2-max Seat #1 is the button
Seat 1: Lorpugo ($30.15 in chips) 
Seat 2: DzemAs ($55.23 in chips) 
Lorpugo: posts small blind $0.25
DzemAs: posts big blind $0.50
*** HOLE CARDS ***
Dealt to Lorpugo [8h 2s]
Lorpugo: folds 
Uncalled bet ($0.25) returned to DzemAs
DzemAs collected $0.50 from pot
DzemAs: doesn't show hand 
*** SUMMARY ***
Total pot $0.50 | Rake $0 
Seat 1: Lorpugo (button) (small blind) folded before Flop
Seat 2: DzemAs (big blind) collected ($0.50)



PokerStars Zoom Hand #236522763472:  Hold'em No Limit ($0.25/$0.50) - 2022/06/02 14:17:20 ET
Table 'C Carinae' 2-max Seat #1 is the button
Seat 1: Mtaneli ($139.81 in chips) 
Seat 2: Lorpugo ($29.90 in chips) 
Mtaneli: posts small blind $0.25
Lorpugo: posts big blind $0.50
*** HOLE CARDS ***
Dealt to Lorpugo [Kh Jc]
Mtaneli: raises $0.72 to $1.22
Lorpugo: calls $0.72
*** FLOP *** [5s 2s 7c]
Lorpugo: checks 
Mtaneli: checks 
*** TURN *** [5s 2s 7c] [Th]
Lorpugo: checks 
Mtaneli: checks 
*** RIVER *** [5s 2s 7c Th] [2h]
Lorpugo: checks 
Mtaneli: checks 
*** SHOW DOWN ***
Lorpugo: shows [Kh Jc] (a pair of Deuces)
Mtaneli: shows [Ac 9s] (a pair of Deuces - Ace kicker)
Mtaneli collected $2.32 from pot
*** SUMMARY ***
Total pot $2.44 | Rake $0.12 
Board [5s 2s 7c Th 2h]
Seat 1: Mtaneli (button) (small blind) showed [Ac 9s] and won ($2.32) with a pair of Deuces
Seat 2: Lorpugo (big blind) showed [Kh Jc] and lost with a pair of Deuces



PokerStars Zoom Hand #236522777439:  Hold'em No Limit ($0.25/$0.50) - 2022/06/02 14:18:01 ET
Table 'C Carinae' 2-max Seat #1 is the button
Seat 1: Lorpugo ($28.68 in chips) 
Seat 2: Mtaneli ($140.91 in chips) 
Lorpugo: posts small blind $0.25
Mtaneli: posts big blind $0.50
*** HOLE CARDS ***
Dealt to Lorpugo [Jh Th]
Lorpugo: raises $0.60 to $1.10
Mtaneli: calls $0.60
*** FLOP *** [Kh 8h 3s]
Mtaneli: checks 
Lorpugo: bets $0.69
Mtaneli: calls $0.69
*** TURN *** [Kh 8h 3s] [4s]
Mtaneli: checks 
Lorpugo: bets $1.12
Mtaneli: calls $1.12
*** RIVER *** [Kh 8h 3s 4s] [8s]
Mtaneli: bets $4.50
Lorpugo: raises $21.27 to $25.77 and is all-in
Mtaneli: folds 
Uncalled bet ($21.27) returned to Lorpugo
Lorpugo collected $14.08 from pot
Lorpugo: doesn't show hand 
*** SUMMARY ***
Total pot $14.82 | Rake $0.74 
Board [Kh 8h 3s 4s 8s]
Seat 1: Lorpugo (button) (small blind) collected ($14.08)
Seat 2: Mtaneli (big blind) folded on the River



PokerStars Zoom Hand #236522804153:  Hold'em No Limit ($0.25/$0.50) - 2022/06/02 14:19:21 ET
Table 'C Carinae' 2-max Seat #1 is the button
Seat 1: Mtaneli ($133.50 in chips) 
Seat 2: Lorpugo ($35.35 in chips) 
Mtaneli: posts small blind $0.25
Lorpugo: posts big blind $0.50
*** HOLE CARDS ***
Dealt to Lorpugo [Ad Td]
Mtaneli: raises $0.72 to $1.22
Lorpugo: calls $0.72
*** FLOP *** [2s 7c 2h]
Lorpugo: checks 
Mtaneli: bets $0.72
Lorpugo: calls $0.72
*** TURN *** [2s 7c 2h] [Ah]
Lorpugo: checks 
Mtaneli: bets $2.88
Lorpugo: calls $2.88
*** RIVER *** [2s 7c 2h Ah] [Qs]
Lorpugo: checks 
Mtaneli: checks 
*** SHOW DOWN ***
Lorpugo: shows [Ad Td] (two pair, Aces and Deuces)
Mtaneli: mucks hand 
Lorpugo collected $9.16 from pot
*** SUMMARY ***
Total pot $9.64 | Rake $0.48 
Board [2s 7c 2h Ah Qs]
Seat 1: Mtaneli (button) (small blind) mucked [8c 3c]
Seat 2: Lorpugo (big blind) showed [Ad Td] and won ($9.16) with two pair, Aces and Deuces



PokerStars Zoom Hand #236522823902:  Hold'em No Limit ($0.25/$0.50) - 2022/06/02 14:20:19 ET
Table 'C Carinae' 2-max Seat #1 is the button
Seat 1: Lorpugo ($39.69 in chips) 
Seat 2: Mtaneli ($128.68 in chips) 
Lorpugo: posts small blind $0.25
Mtaneli: posts big blind $0.50
*** HOLE CARDS ***
Dealt to Lorpugo [As 7h]
Lorpugo: raises $0.60 to $1.10
Mtaneli: calls $0.60
*** FLOP *** [9c 2c 6h]
Mtaneli: checks 
Lorpugo: bets $0.69
Mtaneli: calls $0.69
*** TURN *** [9c 2c 6h] [Qc]
Mtaneli: checks 
Lorpugo: checks 
*** RIVER *** [9c 2c 6h Qc] [4d]
Mtaneli: bets $3
Lorpugo: folds 
Uncalled bet ($3) returned to Mtaneli
Mtaneli collected $3.40 from pot
Mtaneli: doesn't show hand 
*** SUMMARY ***
Total pot $3.58 | Rake $0.18 
Board [9c 2c 6h Qc 4d]
Seat 1: Lorpugo (button) (small blind) folded on the River
Seat 2: Mtaneli (big blind) collected ($3.40)



PokerStars Zoom Hand #236522841353:  Hold'em No Limit ($0.25/$0.50) - 2022/06/02 14:21:11 ET
Table 'C Carinae' 2-max Seat #1 is the button
Seat 1: Mtaneli ($130.29 in chips) 
Seat 2: Lorpugo ($37.90 in chips) 
Mtaneli: posts small blind $0.25
Lorpugo: posts big blind $0.50
*** HOLE CARDS ***
Dealt to Lorpugo [5d 6d]
Mtaneli: raises $0.72 to $1.22
Lorpugo: calls $0.72
*** FLOP *** [5s 3c 8s]
Lorpugo: checks 
Mtaneli: bets $1.11
Lorpugo: calls $1.11
*** TURN *** [5s 3c 8s] [Jd]
Lorpugo: checks 
Mtaneli: bets $3.46
Lorpugo: folds 
Uncalled bet ($3.46) returned to Mtaneli
Mtaneli collected $4.43 from pot
Mtaneli: doesn't show hand 
*** SUMMARY ***
Total pot $4.66 | Rake $0.23 
Board [5s 3c 8s Jd]
Seat 1: Mtaneli (button) (small blind) collected ($4.43)
Seat 2: Lorpugo (big blind) folded on the Turn



PokerStars Zoom Hand #236522859244:  Hold'em No Limit ($0.25/$0.50) - 2022/06/02 14:22:04 ET
Table 'C Carinae' 2-max Seat #1 is the button
Seat 1: Lorpugo ($35.57 in chips) 
Seat 2: friediii11 ($103.75 in chips) 
Lorpugo: posts small blind $0.25
friediii11: posts big blind $0.50
*** HOLE CARDS ***
Dealt to Lorpugo [6s Ad]
Lorpugo: raises $0.60 to $1.10
friediii11: raises $3.90 to $5
Lorpugo: folds 
Uncalled bet ($3.90) returned to friediii11
friediii11 collected $2.20 from pot
friediii11: doesn't show hand 
*** SUMMARY ***
Total pot $2.20 | Rake $0 
Seat 1: Lorpugo (button) (small blind) folded before Flop
Seat 2: friediii11 (big blind) collected ($2.20)



PokerStars Zoom Hand #236522867091:  Hold'em No Limit ($0.25/$0.50) - 2022/06/02 14:22:27 ET
Table 'C Carinae' 2-max Seat #1 is the button
Seat 1: Lorpugo ($34.47 in chips) 
Seat 2: DaftBob ($50 in chips) 
Lorpugo: posts small blind $0.25
DaftBob: posts big blind $0.50
*** HOLE CARDS ***
Dealt to Lorpugo [Qd As]
Lorpugo: raises $0.60 to $1.10
DaftBob: folds 
Uncalled bet ($0.60) returned to Lorpugo
Lorpugo collected $1 from pot
Lorpugo: doesn't show hand 
*** SUMMARY ***
Total pot $1 | Rake $0 
Seat 1: Lorpugo (button) (small blind) collected ($1)
Seat 2: DaftBob (big blind) folded before Flop



PokerStars Zoom Hand #236522870812:  Hold'em No Limit ($0.25/$0.50) - 2022/06/02 14:22:38 ET
Table 'C Carinae' 2-max Seat #1 is the button
Seat 1: DaftBob ($50.75 in chips) 
Seat 2: Lorpugo ($34.97 in chips) 
DaftBob: posts small blind $0.25
Lorpugo: posts big blind $0.50
*** HOLE CARDS ***
Dealt to Lorpugo [Qd 2s]
DaftBob: folds 
Uncalled bet ($0.25) returned to Lorpugo
Lorpugo collected $0.50 from pot
Lorpugo: doesn't show hand 
*** SUMMARY ***
Total pot $0.50 | Rake $0 
Seat 1: DaftBob (button) (small blind) folded before Flop
Seat 2: Lorpugo (big blind) collected ($0.50)



PokerStars Zoom Hand #236522872843:  Hold'em No Limit ($0.25/$0.50) - 2022/06/02 14:22:44 ET
Table 'C Carinae' 2-max Seat #1 is the button
Seat 1: DzemAs ($58.25 in chips) 
Seat 2: Lorpugo ($35.22 in chips) 
DzemAs: posts small blind $0.25
Lorpugo: posts big blind $0.50
*** HOLE CARDS ***
Dealt to Lorpugo [Jc 3s]
DzemAs: folds 
Uncalled bet ($0.25) returned to Lorpugo
Lorpugo collected $0.50 from pot
Lorpugo: doesn't show hand 
*** SUMMARY ***
Total pot $0.50 | Rake $0 
Seat 1: DzemAs (button) (small blind) folded before Flop
Seat 2: Lorpugo (big blind) collected ($0.50)



PokerStars Zoom Hand #236522875227:  Hold'em No Limit ($0.25/$0.50) - 2022/06/02 14:22:51 ET
Table 'C Carinae' 2-max Seat #1 is the button
Seat 1: Lorpugo ($35.47 in chips) 
Seat 2: Hannisy1991 ($100.47 in chips) 
Lorpugo: posts small blind $0.25
Hannisy1991: posts big blind $0.50
*** HOLE CARDS ***
Dealt to Lorpugo [7c Td]
Lorpugo: raises $0.60 to $1.10
Hannisy1991: raises $2.20 to $3.30
Lorpugo: folds 
Uncalled bet ($2.20) returned to Hannisy1991
Hannisy1991 collected $2.20 from pot
Hannisy1991: doesn't show hand 
*** SUMMARY ***
Total pot $2.20 | Rake $0 
Seat 1: Lorpugo (button) (small blind) folded before Flop
Seat 2: Hannisy1991 (big blind) collected ($2.20)



PokerStars Zoom Hand #236522881808:  Hold'em No Limit ($0.25/$0.50) - 2022/06/02 14:23:10 ET
Table 'C Carinae' 2-max Seat #1 is the button
Seat 1: Hannisy1991 ($101.57 in chips) 
Seat 2: Lorpugo ($34.37 in chips) 
Hannisy1991: posts small blind $0.25
Lorpugo: posts big blind $0.50
*** HOLE CARDS ***
Dealt to Lorpugo [2s 6d]
Hannisy1991: raises $0.50 to $1
Lorpugo: folds 
Uncalled bet ($0.50) returned to Hannisy1991
Hannisy1991 collected $1 from pot
Hannisy1991: doesn't show hand 
*** SUMMARY ***
Total pot $1 | Rake $0 
Seat 1: Hannisy1991 (button) (small blind) collected ($1)
Seat 2: Lorpugo (big blind) folded before Flop



PokerStars Zoom Hand #236522887147:  Hold'em No Limit ($0.25/$0.50) - 2022/06/02 14:23:26 ET
Table 'C Carinae' 2-max Seat #1 is the button
Seat 1: Lorpugo ($33.87 in chips) 
Seat 2: Hannisy1991 ($102.07 in chips) 
Lorpugo: posts small blind $0.25
Hannisy1991: posts big blind $0.50
*** HOLE CARDS ***
Dealt to Lorpugo [Tc Jh]
Lorpugo: raises $0.60 to $1.10
Hannisy1991: calls $0.60
*** FLOP *** [As Ad Qc]
Hannisy1991: checks 
Lorpugo: bets $0.69
Hannisy1991: raises $0.81 to $1.50
Lorpugo: folds 
Uncalled bet ($0.81) returned to Hannisy1991
Hannisy1991 collected $3.36 from pot
Hannisy1991: doesn't show hand 
*** SUMMARY ***
Total pot $3.58 | Rake $0.22 
Board [As Ad Qc]
Seat 1: Lorpugo (button) (small blind) folded on the Flop
Seat 2: Hannisy1991 (big blind) collected ($3.36)



PokerStars Zoom Hand #236522897405:  Hold'em No Limit ($0.25/$0.50) - 2022/06/02 14:23:56 ET
Table 'C Carinae' 2-max Seat #1 is the button
Seat 1: KillerSword ($22.05 in chips) 
Seat 2: Lorpugo ($32.08 in chips) 
KillerSword: posts small blind $0.25
Lorpugo: posts big blind $0.50
*** HOLE CARDS ***
Dealt to Lorpugo [Ad 5h]
KillerSword: raises $0.50 to $1
Lorpugo: calls $0.50
*** FLOP *** [Kh Qd Qh]
Lorpugo: checks 
KillerSword: checks 
*** TURN *** [Kh Qd Qh] [7c]
Lorpugo: checks 
KillerSword: checks 
*** RIVER *** [Kh Qd Qh 7c] [6h]
Lorpugo: bets $0.50
KillerSword: calls $0.50
*** SHOW DOWN ***
Lorpugo: shows [Ad 5h] (a pair of Queens)
KillerSword: shows [5d As] (a pair of Queens)
Lorpugo collected $1.43 from pot
KillerSword collected $1.42 from pot
*** SUMMARY ***
Total pot $3 | Rake $0.15 
Board [Kh Qd Qh 7c 6h]
Seat 1: KillerSword (button) (small blind) showed [5d As] and won ($1.42) with a pair of Queens
Seat 2: Lorpugo (big blind) showed [Ad 5h] and won ($1.43) with a pair of Queens



PokerStars Zoom Hand #236522912326:  Hold'em No Limit ($0.25/$0.50) - 2022/06/02 14:24:40 ET
Table 'C Carinae' 2-max Seat #1 is the button
Seat 1: Lorpugo ($32.01 in chips) 
Seat 2: friediii11 ($160.26 in chips) 
Lorpugo: posts small blind $0.25
friediii11: posts big blind $0.50
*** HOLE CARDS ***
Dealt to Lorpugo [2h 4s]
Lorpugo: folds 
Uncalled bet ($0.25) returned to friediii11
friediii11 collected $0.50 from pot
friediii11: doesn't show hand 
*** SUMMARY ***
Total pot $0.50 | Rake $0 
Seat 1: Lorpugo (button) (small blind) folded before Flop
Seat 2: friediii11 (big blind) collected ($0.50)



PokerStars Zoom Hand #236522915431:  Hold'em No Limit ($0.25/$0.50) - 2022/06/02 14:24:49 ET
Table 'C Carinae' 2-max Seat #1 is the button
Seat 1: QuakieMan ($80.60 in chips) 
Seat 2: Lorpugo ($31.76 in chips) 
QuakieMan: posts small blind $0.25
Lorpugo: posts big blind $0.50
*** HOLE CARDS ***
Dealt to Lorpugo [8c As]
QuakieMan: raises $0.60 to $1.10
Lorpugo: raises $2.40 to $3.50
QuakieMan: calls $2.40
*** FLOP *** [9c Kc 8d]
Lorpugo: bets $2.19
QuakieMan: folds 
Uncalled bet ($2.19) returned to Lorpugo
Lorpugo collected $6.65 from pot
Lorpugo: doesn't show hand 
*** SUMMARY ***
Total pot $7 | Rake $0.35 
Board [9c Kc 8d]
Seat 1: QuakieMan (button) (small blind) folded on the Flop
Seat 2: Lorpugo (big blind) collected ($6.65)



PokerStars Zoom Hand #236522925803:  Hold'em No Limit ($0.25/$0.50) - 2022/06/02 14:25:20 ET
Table 'C Carinae' 2-max Seat #1 is the button
Seat 1: Lorpugo ($34.91 in chips) 
Seat 2: Pooface77 ($51.65 in chips) 
Lorpugo: posts small blind $0.25
Pooface77: posts big blind $0.50
*** HOLE CARDS ***
Dealt to Lorpugo [Kc 9d]
Lorpugo: raises $0.60 to $1.10
Pooface77: folds 
Uncalled bet ($0.60) returned to Lorpugo
Lorpugo collected $1 from pot
Lorpugo: doesn't show hand 
*** SUMMARY ***
Total pot $1 | Rake $0 
Seat 1: Lorpugo (button) (small blind) collected ($1)
Seat 2: Pooface77 (big blind) folded before Flop



PokerStars Zoom Hand #236522930220:  Hold'em No Limit ($0.25/$0.50) - 2022/06/02 14:25:33 ET
Table 'C Carinae' 2-max Seat #1 is the button
Seat 1: friediii11 ($158.26 in chips) 
Seat 2: Lorpugo ($35.41 in chips) 
friediii11: posts small blind $0.25
Lorpugo: posts big blind $0.50
*** HOLE CARDS ***
Dealt to Lorpugo [8h 8c]
friediii11: raises $0.75 to $1.25
Lorpugo: calls $0.75
*** FLOP *** [8s 9s 2s]
Lorpugo: checks 
friediii11: checks 
*** TURN *** [8s 9s 2s] [Ac]
Lorpugo: bets $0.79
friediii11: calls $0.79
*** RIVER *** [8s 9s 2s Ac] [4s]
Lorpugo: checks 
friediii11: bets $2.91
Lorpugo: folds 
Uncalled bet ($2.91) returned to friediii11
friediii11 collected $3.83 from pot
friediii11: doesn't show hand 
*** SUMMARY ***
Total pot $4.08 | Rake $0.25 
Board [8s 9s 2s Ac 4s]
Seat 1: friediii11 (button) (small blind) collected ($3.83)
Seat 2: Lorpugo (big blind) folded on the River



PokerStars Zoom Hand #236522946285:  Hold'em No Limit ($0.25/$0.50) - 2022/06/02 14:26:20 ET
Table 'C Carinae' 2-max Seat #1 is the button
Seat 1: Seepferdi ($56.46 in chips) 
Seat 2: Lorpugo ($33.37 in chips) 
Seepferdi: posts small blind $0.25
Lorpugo: posts big blind $0.50
*** HOLE CARDS ***
Dealt to Lorpugo [6c 3c]
Seepferdi: calls $0.25
Lorpugo: checks 
*** FLOP *** [2h Kd 8d]
Lorpugo: checks 
Seepferdi: checks 
*** TURN *** [2h Kd 8d] [Js]
Lorpugo: checks 
Seepferdi: checks 
*** RIVER *** [2h Kd 8d Js] [4d]
Lorpugo: bets $0.95
Seepferdi: folds 
Uncalled bet ($0.95) returned to Lorpugo
Lorpugo collected $0.95 from pot
Lorpugo: doesn't show hand 
*** SUMMARY ***
Total pot $1 | Rake $0.05 
Board [2h Kd 8d Js 4d]
Seat 1: Seepferdi (button) (small blind) folded on the River
Seat 2: Lorpugo (big blind) collected ($0.95)



PokerStars Zoom Hand #236522957205:  Hold'em No Limit ($0.25/$0.50) - 2022/06/02 14:26:52 ET
Table 'C Carinae' 2-max Seat #1 is the button
Seat 1: Lorpugo ($33.82 in chips) 
Seat 2: DzemAs ($65.38 in chips) 
Lorpugo: posts small blind $0.25
DzemAs: posts big blind $0.50
*** HOLE CARDS ***
Dealt to Lorpugo [Ad 7c]
Lorpugo: raises $0.60 to $1.10
DzemAs: folds 
Uncalled bet ($0.60) returned to Lorpugo
Lorpugo collected $1 from pot
Lorpugo: doesn't show hand 
*** SUMMARY ***
Total pot $1 | Rake $0 
Seat 1: Lorpugo (button) (small blind) collected ($1)
Seat 2: DzemAs (big blind) folded before Flop



PokerStars Zoom Hand #236522961591:  Hold'em No Limit ($0.25/$0.50) - 2022/06/02 14:27:05 ET
Table 'C Carinae' 2-max Seat #1 is the button
Seat 1: DaftBob ($57.41 in chips) 
Seat 2: Lorpugo ($34.32 in chips) 
DaftBob: posts small blind $0.25
Lorpugo: posts big blind $0.50
*** HOLE CARDS ***
Dealt to Lorpugo [4h 9c]
DaftBob: raises $0.50 to $1
Lorpugo: folds 
Uncalled bet ($0.50) returned to DaftBob
DaftBob collected $1 from pot
DaftBob: doesn't show hand 
*** SUMMARY ***
Total pot $1 | Rake $0 
Seat 1: DaftBob (button) (small blind) collected ($1)
Seat 2: Lorpugo (big blind) folded before Flop



PokerStars Zoom Hand #236522970466:  Hold'em No Limit ($0.25/$0.50) - 2022/06/02 14:27:31 ET
Table 'C Carinae' 2-max Seat #1 is the button
Seat 1: Lorpugo ($33.82 in chips) 
Seat 2: fabsee1 ($50.88 in chips) 
Lorpugo: posts small blind $0.25
fabsee1: posts big blind $0.50
*** HOLE CARDS ***
Dealt to Lorpugo [3h 3s]
Lorpugo: raises $0.60 to $1.10
fabsee1: raises $3.20 to $4.30
Lorpugo: folds 
Uncalled bet ($3.20) returned to fabsee1
fabsee1 collected $2.20 from pot
fabsee1: doesn't show hand 
*** SUMMARY ***
Total pot $2.20 | Rake $0 
Seat 1: Lorpugo (button) (small blind) folded before Flop
Seat 2: fabsee1 (big blind) collected ($2.20)



PokerStars Zoom Hand #236522976234:  Hold'em No Limit ($0.25/$0.50) - 2022/06/02 14:27:48 ET
Table 'C Carinae' 2-max Seat #1 is the button
Seat 1: DaftBob ($58.93 in chips) 
Seat 2: Lorpugo ($32.72 in chips) 
DaftBob: posts small blind $0.25
Lorpugo: posts big blind $0.50
*** HOLE CARDS ***
Dealt to Lorpugo [9s 8s]
DaftBob: raises $3 to $3.50
Lorpugo: folds 
Uncalled bet ($3) returned to DaftBob
DaftBob collected $1 from pot
DaftBob: doesn't show hand 
*** SUMMARY ***
Total pot $1 | Rake $0 
Seat 1: DaftBob (button) (small blind) collected ($1)
Seat 2: Lorpugo (big blind) folded before Flop



PokerStars Zoom Hand #236522982511:  Hold'em No Limit ($0.25/$0.50) - 2022/06/02 14:28:07 ET
Table 'C Carinae' 2-max Seat #1 is the button
Seat 1: Lorpugo ($32.22 in chips) 
Seat 2: Pooface77 ($51.13 in chips) 
Lorpugo: posts small blind $0.25
Pooface77: posts big blind $0.50
*** HOLE CARDS ***
Dealt to Lorpugo [9h 7c]
Lorpugo: raises $0.60 to $1.10
Pooface77: calls $0.60
*** FLOP *** [Ks 4d Kc]
Pooface77: checks 
Lorpugo: bets $0.69
Pooface77: folds 
Uncalled bet ($0.69) returned to Lorpugo
Lorpugo collected $2.09 from pot
Lorpugo: doesn't show hand 
*** SUMMARY ***
Total pot $2.20 | Rake $0.11 
Board [Ks 4d Kc]
Seat 1: Lorpugo (button) (small blind) collected ($2.09)
Seat 2: Pooface77 (big blind) folded on the Flop



PokerStars Zoom Hand #236522994990:  Hold'em No Limit ($0.25/$0.50) - 2022/06/02 14:28:43 ET
Table 'C Carinae' 2-max Seat #1 is the button
Seat 1: DaftBob ($76.74 in chips) 
Seat 2: Lorpugo ($33.21 in chips) 
DaftBob: posts small blind $0.25
Lorpugo: posts big blind $0.50
*** HOLE CARDS ***
Dealt to Lorpugo [5d 5s]
DaftBob: raises $0.50 to $1
Lorpugo: calls $0.50
*** FLOP *** [Qc Kc Qd]
Lorpugo: checks 
DaftBob: bets $0.50
Lorpugo: calls $0.50
*** TURN *** [Qc Kc Qd] [Jh]
Lorpugo: checks 
DaftBob: checks 
*** RIVER *** [Qc Kc Qd Jh] [2c]
Lorpugo: bets $0.50
DaftBob: calls $0.50
*** SHOW DOWN ***
Lorpugo: shows [5d 5s] (two pair, Queens and Fives)
DaftBob: shows [Ts Jc] (two pair, Queens and Jacks)
DaftBob collected $3.80 from pot
*** SUMMARY ***
Total pot $4 | Rake $0.20 
Board [Qc Kc Qd Jh 2c]
Seat 1: DaftBob (button) (small blind) showed [Ts Jc] and won ($3.80) with two pair, Queens and Jacks
Seat 2: Lorpugo (big blind) showed [5d 5s] and lost with two pair, Queens and Fives



PokerStars Zoom Hand #236523012236:  Hold'em No Limit ($0.25/$0.50) - 2022/06/02 14:29:34 ET
Table 'C Carinae' 2-max Seat #1 is the button
Seat 1: Lorpugo ($31.21 in chips) 
Seat 2: fabsee1 ($56.21 in chips) 
Lorpugo: posts small blind $0.25
fabsee1: posts big blind $0.50
*** HOLE CARDS ***
Dealt to Lorpugo [6h 6d]
Lorpugo: raises $0.60 to $1.10
fabsee1: raises $3.20 to $4.30
Lorpugo: folds 
Uncalled bet ($3.20) returned to fabsee1
fabsee1 collected $2.20 from pot
fabsee1: doesn't show hand 
*** SUMMARY ***
Total pot $2.20 | Rake $0 
Seat 1: Lorpugo (button) (small blind) folded before Flop
Seat 2: fabsee1 (big blind) collected ($2.20)



PokerStars Zoom Hand #236523019403:  Hold'em No Limit ($0.25/$0.50) - 2022/06/02 14:29:56 ET
Table 'C Carinae' 2-max Seat #1 is the button
Seat 1: Lorpugo ($30.11 in chips) 
Seat 2: DzemAs ($70.94 in chips) 
Lorpugo: posts small blind $0.25
DzemAs: posts big blind $0.50
*** HOLE CARDS ***
Dealt to Lorpugo [3h 2c]
Lorpugo: folds 
Uncalled bet ($0.25) returned to DzemAs
DzemAs collected $0.50 from pot
DzemAs: doesn't show hand 
*** SUMMARY ***
Total pot $0.50 | Rake $0 
Seat 1: Lorpugo (button) (small blind) folded before Flop
Seat 2: DzemAs (big blind) collected ($0.50)



PokerStars Zoom Hand #236523022099:  Hold'em No Limit ($0.25/$0.50) - 2022/06/02 14:30:03 ET
Table 'C Carinae' 2-max Seat #1 is the button
Seat 1: friediii11 ($287.74 in chips) 
Seat 2: Lorpugo ($29.86 in chips) 
friediii11: posts small blind $0.25
Lorpugo: posts big blind $0.50
*** HOLE CARDS ***
Dealt to Lorpugo [2s Tc]
friediii11: folds 
Uncalled bet ($0.25) returned to Lorpugo
Lorpugo collected $0.50 from pot
Lorpugo: doesn't show hand 
*** SUMMARY ***
Total pot $0.50 | Rake $0 
Seat 1: friediii11 (button) (small blind) folded before Flop
Seat 2: Lorpugo (big blind) collected ($0.50)



PokerStars Zoom Hand #236523024802:  Hold'em No Limit ($0.25/$0.50) - 2022/06/02 14:30:11 ET
Table 'C Carinae' 2-max Seat #1 is the button
Seat 1: Lorpugo ($30.11 in chips) 
Seat 2: friediii11 ($287.49 in chips) 
Lorpugo: posts small blind $0.25
friediii11: posts big blind $0.50
*** HOLE CARDS ***
Dealt to Lorpugo [Ac 2c]
Lorpugo: raises $0.60 to $1.10
friediii11: raises $3.90 to $5
Lorpugo: raises $25.11 to $30.11 and is all-in
friediii11: folds 
Uncalled bet ($25.11) returned to Lorpugo
Lorpugo collected $10 from pot
Lorpugo: doesn't show hand 
*** SUMMARY ***
Total pot $10 | Rake $0 
Seat 1: Lorpugo (button) (small blind) collected ($10)
Seat 2: friediii11 (big blind) folded before Flop



PokerStars Zoom Hand #236523032814:  Hold'em No Limit ($0.25/$0.50) - 2022/06/02 14:30:34 ET
Table 'C Carinae' 2-max Seat #1 is the button
Seat 1: KillerSword ($12.95 in chips) 
Seat 2: Lorpugo ($35.11 in chips) 
KillerSword: posts small blind $0.25
Lorpugo: posts big blind $0.50
*** HOLE CARDS ***
Dealt to Lorpugo [9s 7d]
KillerSword: raises $0.50 to $1
Lorpugo: calls $0.50
*** FLOP *** [9d 3d 2s]
Lorpugo: checks 
KillerSword: checks 
*** TURN *** [9d 3d 2s] [4d]
Lorpugo: checks 
KillerSword: checks 
*** RIVER *** [9d 3d 2s 4d] [Th]
Lorpugo: checks 
KillerSword: checks 
*** SHOW DOWN ***
Lorpugo: shows [9s 7d] (a pair of Nines)
KillerSword: mucks hand 
Lorpugo collected $1.90 from pot
*** SUMMARY ***
Total pot $2 | Rake $0.10 
Board [9d 3d 2s 4d Th]
Seat 1: KillerSword (button) (small blind) mucked [Ah 2c]
Seat 2: Lorpugo (big blind) showed [9s 7d] and won ($1.90) with a pair of Nines



PokerStars Zoom Hand #236523060669:  Hold'em No Limit ($0.25/$0.50) - 2022/06/02 14:31:37 ET
Table 'C Carinae' 2-max Seat #1 is the button
Seat 1: Lorpugo ($36.01 in chips) 
Seat 2: friediii11 ($284.67 in chips) 
Lorpugo: posts small blind $0.25
friediii11: posts big blind $0.50
*** HOLE CARDS ***
Dealt to Lorpugo [5h 3h]
Lorpugo: raises $0.50 to $1
friediii11: folds 
Uncalled bet ($0.50) returned to Lorpugo
Lorpugo collected $1 from pot
Lorpugo: doesn't show hand 
*** SUMMARY ***
Total pot $1 | Rake $0 
Seat 1: Lorpugo (button) (small blind) collected ($1)
Seat 2: friediii11 (big blind) folded before Flop



PokerStars Zoom Hand #236523065031:  Hold'em No Limit ($0.25/$0.50) - 2022/06/02 14:31:49 ET
Table 'C Carinae' 2-max Seat #1 is the button
Seat 1: DzemAs ($57.97 in chips) 
Seat 2: Lorpugo ($36.51 in chips) 
DzemAs: posts small blind $0.25
Lorpugo: posts big blind $0.50
*** HOLE CARDS ***
Dealt to Lorpugo [6d Jc]
DzemAs: raises $0.65 to $1.15
Lorpugo: folds 
Uncalled bet ($0.65) returned to DzemAs
DzemAs collected $1 from pot
DzemAs: doesn't show hand 
*** SUMMARY ***
Total pot $1 | Rake $0 
Seat 1: DzemAs (button) (small blind) collected ($1)
Seat 2: Lorpugo (big blind) folded before Flop



PokerStars Zoom Hand #236523069138:  Hold'em No Limit ($0.25/$0.50) - 2022/06/02 14:32:01 ET
Table 'C Carinae' 2-max Seat #1 is the button
Seat 1: Lorpugo ($36.01 in chips) 
Seat 2: Mtaneli ($50.25 in chips) 
Lorpugo: posts small blind $0.25
Mtaneli: posts big blind $0.50
*** HOLE CARDS ***
Dealt to Lorpugo [Ks 6d]
Lorpugo: raises $0.50 to $1
Mtaneli: calls $0.50
*** FLOP *** [Kc 3c 2d]
Mtaneli: checks 
Lorpugo: bets $0.63
Mtaneli: calls $0.63
*** TURN *** [Kc 3c 2d] [8d]
Mtaneli: checks 
Lorpugo: bets $1.60
Mtaneli: calls $1.60
*** RIVER *** [Kc 3c 2d 8d] [Qh]
Mtaneli: checks 
Lorpugo: bets $5
Mtaneli: calls $5
*** SHOW DOWN ***
Lorpugo: shows [Ks 6d] (a pair of Kings)
Mtaneli: shows [3s Qs] (two pair, Queens and Threes)
Mtaneli collected $15.71 from pot
*** SUMMARY ***
Total pot $16.46 | Rake $0.75 
Board [Kc 3c 2d 8d Qh]
Seat 1: Lorpugo (button) (small blind) showed [Ks 6d] and lost with a pair of Kings
Seat 2: Mtaneli (big blind) showed [3s Qs] and won ($15.71) with two pair, Queens and Threes



PokerStars Zoom Hand #236523089722:  Hold'em No Limit ($0.25/$0.50) - 2022/06/02 14:33:01 ET
Table 'C Carinae' 2-max Seat #1 is the button
Seat 1: Mtaneli ($57.73 in chips) 
Seat 2: Lorpugo ($27.78 in chips) 
Mtaneli: posts small blind $0.25
Lorpugo: posts big blind $0.50
*** HOLE CARDS ***
Dealt to Lorpugo [5d 5s]
Mtaneli: raises $0.72 to $1.22
Lorpugo: calls $0.72
*** FLOP *** [6s 2d 7c]
Lorpugo: checks 
Mtaneli: bets $0.72
Lorpugo: folds 
Uncalled bet ($0.72) returned to Mtaneli
Mtaneli collected $2.32 from pot
Mtaneli: doesn't show hand 
*** SUMMARY ***
Total pot $2.44 | Rake $0.12 
Board [6s 2d 7c]
Seat 1: Mtaneli (button) (small blind) collected ($2.32)
Seat 2: Lorpugo (big blind) folded on the Flop



PokerStars Zoom Hand #236523100521:  Hold'em No Limit ($0.25/$0.50) - 2022/06/02 14:33:32 ET
Table 'C Carinae' 2-max Seat #1 is the button
Seat 1: Lorpugo ($26.56 in chips) 
Seat 2: DaftBob ($81.16 in chips) 
Lorpugo: posts small blind $0.25
DaftBob: posts big blind $0.50
*** HOLE CARDS ***
Dealt to Lorpugo [4s Kc]
Lorpugo: raises $0.60 to $1.10
DaftBob: raises $2.40 to $3.50
Lorpugo: folds 
Uncalled bet ($2.40) returned to DaftBob
DaftBob collected $2.20 from pot
DaftBob: doesn't show hand 
*** SUMMARY ***
Total pot $2.20 | Rake $0 
Seat 1: Lorpugo (button) (small blind) folded before Flop
Seat 2: DaftBob (big blind) collected ($2.20)



PokerStars Zoom Hand #236523107284:  Hold'em No Limit ($0.25/$0.50) - 2022/06/02 14:33:51 ET
Table 'C Carinae' 2-max Seat #1 is the button
Seat 1: Lorpugo ($25.46 in chips) 
Seat 2: drissmouzou ($28.48 in chips) 
Lorpugo: posts small blind $0.25
drissmouzou: posts big blind $0.50
*** HOLE CARDS ***
Dealt to Lorpugo [Jc 9d]
Lorpugo: raises $0.60 to $1.10
drissmouzou: raises $0.60 to $1.70
Lorpugo: calls $0.60
*** FLOP *** [7h 4s Qs]
drissmouzou: bets $1.62
Lorpugo: folds 
Uncalled bet ($1.62) returned to drissmouzou
drissmouzou collected $3.23 from pot
drissmouzou: doesn't show hand 
*** SUMMARY ***
Total pot $3.40 | Rake $0.17 
Board [7h 4s Qs]
Seat 1: Lorpugo (button) (small blind) folded on the Flop
Seat 2: drissmouzou (big blind) collected ($3.23)



PokerStars Zoom Hand #236523118037:  Hold'em No Limit ($0.25/$0.50) - 2022/06/02 14:34:22 ET
Table 'C Carinae' 2-max Seat #1 is the button
Seat 1: drissmouzou ($30.01 in chips) 
Seat 2: Lorpugo ($23.76 in chips) 
drissmouzou: posts small blind $0.25
Lorpugo: posts big blind $0.50
*** HOLE CARDS ***
Dealt to Lorpugo [3h As]
drissmouzou: raises $0.50 to $1
Lorpugo: calls $0.50
*** FLOP *** [9h 6h 9d]
Lorpugo: checks 
drissmouzou: bets $0.50
Lorpugo: calls $0.50
*** TURN *** [9h 6h 9d] [Kc]
Lorpugo: checks 
drissmouzou: checks 
*** RIVER *** [9h 6h 9d Kc] [Kd]
Lorpugo: bets $0.94
drissmouzou: folds 
Uncalled bet ($0.94) returned to Lorpugo
Lorpugo collected $2.85 from pot
Lorpugo: doesn't show hand 
*** SUMMARY ***
Total pot $3 | Rake $0.15 
Board [9h 6h 9d Kc Kd]
Seat 1: drissmouzou (button) (small blind) folded on the River
Seat 2: Lorpugo (big blind) collected ($2.85)



PokerStars Zoom Hand #236523515008:  Hold'em No Limit ($0.25/$0.50) - 2022/06/02 14:53:25 ET
Table 'C Carinae' 2-max Seat #1 is the button
Seat 1: DaftBob ($100.27 in chips) 
Seat 2: Lorpugo ($25 in chips) 
DaftBob: posts small blind $0.25
Lorpugo: posts big blind $0.50
*** HOLE CARDS ***
Dealt to Lorpugo [4s Tc]
DaftBob: folds 
Uncalled bet ($0.25) returned to Lorpugo
Lorpugo collected $0.50 from pot
Lorpugo: doesn't show hand 
*** SUMMARY ***
Total pot $0.50 | Rake $0 
Seat 1: DaftBob (button) (small blind) folded before Flop
Seat 2: Lorpugo (big blind) collected ($0.50)



PokerStars Zoom Hand #236523517287:  Hold'em No Limit ($0.25/$0.50) - 2022/06/02 14:53:32 ET
Table 'C Carinae' 2-max Seat #1 is the button
Seat 1: Lorpugo ($25.25 in chips) 
Seat 2: candonga ($50 in chips) 
Lorpugo: posts small blind $0.25
candonga: posts big blind $0.50
*** HOLE CARDS ***
Dealt to Lorpugo [9s Ad]
Lorpugo: raises $0.60 to $1.10
candonga: calls $0.60
*** FLOP *** [4d 3d Jh]
candonga: checks 
Lorpugo: bets $0.69
candonga: calls $0.69
*** TURN *** [4d 3d Jh] [6h]
candonga: checks 
Lorpugo: checks 
*** RIVER *** [4d 3d Jh 6h] [7c]
candonga: bets $2.55
Lorpugo: folds 
Uncalled bet ($2.55) returned to candonga
candonga collected $3.40 from pot
candonga: doesn't show hand 
*** SUMMARY ***
Total pot $3.58 | Rake $0.18 
Board [4d 3d Jh 6h 7c]
Seat 1: Lorpugo (button) (small blind) folded on the River
Seat 2: candonga (big blind) collected ($3.40)



PokerStars Zoom Hand #236523532533:  Hold'em No Limit ($0.25/$0.50) - 2022/06/02 14:54:16 ET
Table 'C Carinae' 2-max Seat #1 is the button
Seat 1: Limerickey71 ($13.83 in chips) 
Seat 2: Lorpugo ($23.46 in chips) 
Limerickey71: posts small blind $0.25
Lorpugo: posts big blind $0.50
*** HOLE CARDS ***
Dealt to Lorpugo [2d 8h]
Limerickey71: folds 
Uncalled bet ($0.25) returned to Lorpugo
Lorpugo collected $0.50 from pot
Lorpugo: doesn't show hand 
*** SUMMARY ***
Total pot $0.50 | Rake $0 
Seat 1: Limerickey71 (button) (small blind) folded before Flop
Seat 2: Lorpugo (big blind) collected ($0.50)



PokerStars Zoom Hand #236523535188:  Hold'em No Limit ($0.25/$0.50) - 2022/06/02 14:54:24 ET
Table 'C Carinae' 2-max Seat #1 is the button
Seat 1: Lorpugo ($23.71 in chips) 
Seat 2: M4GPI3 ($50 in chips) 
Lorpugo: posts small blind $0.25
M4GPI3: posts big blind $0.50
*** HOLE CARDS ***
Dealt to Lorpugo [7s Qd]
Lorpugo: raises $0.60 to $1.10
M4GPI3: raises $2.90 to $4
Lorpugo: folds 
Uncalled bet ($2.90) returned to M4GPI3
M4GPI3 collected $2.20 from pot
M4GPI3: doesn't show hand 
*** SUMMARY ***
Total pot $2.20 | Rake $0 
Seat 1: Lorpugo (button) (small blind) folded before Flop
Seat 2: M4GPI3 (big blind) collected ($2.20)



PokerStars Zoom Hand #236523543835:  Hold'em No Limit ($0.25/$0.50) - 2022/06/02 14:54:49 ET
Table 'C Carinae' 2-max Seat #1 is the button
Seat 1: friediii11 ($190.84 in chips) 
Seat 2: Lorpugo ($22.61 in chips) 
friediii11: posts small blind $0.25
Lorpugo: posts big blind $0.50
*** HOLE CARDS ***
Dealt to Lorpugo [Jd 3h]
friediii11: raises $0.75 to $1.25
Lorpugo: folds 
Uncalled bet ($0.75) returned to friediii11
friediii11 collected $1 from pot
friediii11: doesn't show hand 
*** SUMMARY ***
Total pot $1 | Rake $0 
Seat 1: friediii11 (button) (small blind) collected ($1)
Seat 2: Lorpugo (big blind) folded before Flop



PokerStars Zoom Hand #236523550038:  Hold'em No Limit ($0.25/$0.50) - 2022/06/02 14:55:07 ET
Table 'C Carinae' 2-max Seat #1 is the button
Seat 1: Lorpugo ($22.11 in chips) 
Seat 2: fabsee1 ($98.99 in chips) 
Lorpugo: posts small blind $0.25
fabsee1: posts big blind $0.50
*** HOLE CARDS ***
Dealt to Lorpugo [2h 6c]
Lorpugo: folds 
Uncalled bet ($0.25) returned to fabsee1
fabsee1 collected $0.50 from pot
fabsee1: doesn't show hand 
*** SUMMARY ***
Total pot $0.50 | Rake $0 
Seat 1: Lorpugo (button) (small blind) folded before Flop
Seat 2: fabsee1 (big blind) collected ($0.50)



PokerStars Zoom Hand #236523552599:  Hold'em No Limit ($0.25/$0.50) - 2022/06/02 14:55:15 ET
Table 'C Carinae' 2-max Seat #1 is the button
Seat 1: rotnem78 ($59.03 in chips) 
Seat 2: Lorpugo ($21.86 in chips) 
rotnem78: posts small blind $0.25
Lorpugo: posts big blind $0.50
*** HOLE CARDS ***
Dealt to Lorpugo [4c 4d]
rotnem78: calls $0.25
Lorpugo: checks 
*** FLOP *** [As 6s Qc]
Lorpugo: checks 
rotnem78: checks 
*** TURN *** [As 6s Qc] [7s]
Lorpugo: checks 
rotnem78: checks 
*** RIVER *** [As 6s Qc 7s] [8s]
Lorpugo: checks 
rotnem78: checks 
*** SHOW DOWN ***
Lorpugo: shows [4c 4d] (a pair of Fours)
rotnem78: shows [7c 6d] (two pair, Sevens and Sixes)
rotnem78 collected $0.94 from pot
*** SUMMARY ***
Total pot $1 | Rake $0.06 
Board [As 6s Qc 7s 8s]
Seat 1: rotnem78 (button) (small blind) showed [7c 6d] and won ($0.94) with two pair, Sevens and Sixes
Seat 2: Lorpugo (big blind) showed [4c 4d] and lost with a pair of Fours



PokerStars Zoom Hand #236523557260:  Hold'em No Limit ($0.25/$0.50) - 2022/06/02 14:55:32 ET
Table 'C Carinae' 2-max Seat #1 is the button
Seat 1: Lorpugo ($21.36 in chips) 
Seat 2: Pooface77 ($74.37 in chips) 
Lorpugo: posts small blind $0.25
Pooface77: posts big blind $0.50
*** HOLE CARDS ***
Dealt to Lorpugo [Tc 2c]
Lorpugo: raises $0.60 to $1.10
Pooface77: folds 
Uncalled bet ($0.60) returned to Lorpugo
Lorpugo collected $1 from pot
Lorpugo: doesn't show hand 
*** SUMMARY ***
Total pot $1 | Rake $0 
Seat 1: Lorpugo (button) (small blind) collected ($1)
Seat 2: Pooface77 (big blind) folded before Flop



PokerStars Zoom Hand #236523560350:  Hold'em No Limit ($0.25/$0.50) - 2022/06/02 14:55:44 ET
Table 'C Carinae' 2-max Seat #1 is the button
Seat 1: Szar448 ($77.53 in chips) 
Seat 2: Lorpugo ($21.86 in chips) 
Szar448: posts small blind $0.25
Lorpugo: posts big blind $0.50
*** HOLE CARDS ***
Dealt to Lorpugo [8d 6s]
Szar448: calls $0.25
Lorpugo: checks 
*** FLOP *** [6d 7c Js]
Lorpugo: checks 
Szar448: bets $1.50
Lorpugo: folds 
Uncalled bet ($1.50) returned to Szar448
Szar448 collected $0.94 from pot
Szar448: doesn't show hand 
*** SUMMARY ***
Total pot $1 | Rake $0.06 
Board [6d 7c Js]
Seat 1: Szar448 (button) (small blind) collected ($0.94)
Seat 2: Lorpugo (big blind) folded on the Flop



PokerStars Zoom Hand #236523564671:  Hold'em No Limit ($0.25/$0.50) - 2022/06/02 14:56:00 ET
Table 'C Carinae' 2-max Seat #1 is the button
Seat 1: Lorpugo ($21.36 in chips) 
Seat 2: Limerickey71 ($53.05 in chips) 
Lorpugo: posts small blind $0.25
Limerickey71: posts big blind $0.50
*** HOLE CARDS ***
Dealt to Lorpugo [6c 4c]
Lorpugo: raises $0.60 to $1.10
Limerickey71: folds 
Uncalled bet ($0.60) returned to Lorpugo
Lorpugo collected $1 from pot
Lorpugo: doesn't show hand 
*** SUMMARY ***
Total pot $1 | Rake $0 
Seat 1: Lorpugo (button) (small blind) collected ($1)
Seat 2: Limerickey71 (big blind) folded before Flop



PokerStars Zoom Hand #236523567508:  Hold'em No Limit ($0.25/$0.50) - 2022/06/02 14:56:11 ET
Table 'C Carinae' 2-max Seat #1 is the button
Seat 1: fabsee1 ($101.44 in chips) 
Seat 2: Lorpugo ($21.86 in chips) 
fabsee1: posts small blind $0.25
Lorpugo: posts big blind $0.50
*** HOLE CARDS ***
Dealt to Lorpugo [9d 9s]
fabsee1: raises $0.50 to $1
Lorpugo: raises $2.50 to $3.50
fabsee1: folds 
Uncalled bet ($2.50) returned to Lorpugo
Lorpugo collected $2 from pot
Lorpugo: doesn't show hand 
*** SUMMARY ***
Total pot $2 | Rake $0 
Seat 1: fabsee1 (button) (small blind) folded before Flop
Seat 2: Lorpugo (big blind) collected ($2)



PokerStars Zoom Hand #236523571653:  Hold'em No Limit ($0.25/$0.50) - 2022/06/02 14:56:27 ET
Table 'C Carinae' 2-max Seat #1 is the button
Seat 1: Lorpugo ($22.86 in chips) 
Seat 2: KillerSword ($31.14 in chips) 
Lorpugo: posts small blind $0.25
KillerSword: posts big blind $0.50
*** HOLE CARDS ***
Dealt to Lorpugo [9s Kd]
Lorpugo: raises $0.60 to $1.10
KillerSword: calls $0.60
*** FLOP *** [Ts Tc 7s]
KillerSword: checks 
Lorpugo: checks 
*** TURN *** [Ts Tc 7s] [5d]
KillerSword: checks 
Lorpugo: checks 
*** RIVER *** [Ts Tc 7s 5d] [4c]
KillerSword: checks 
Lorpugo: checks 
*** SHOW DOWN ***
KillerSword: shows [9h Kh] (a pair of Tens)
Lorpugo: shows [9s Kd] (a pair of Tens)
KillerSword collected $1.05 from pot
Lorpugo collected $1.04 from pot
*** SUMMARY ***
Total pot $2.20 | Rake $0.11 
Board [Ts Tc 7s 5d 4c]
Seat 1: Lorpugo (button) (small blind) showed [9s Kd] and won ($1.04) with a pair of Tens
Seat 2: KillerSword (big blind) showed [9h Kh] and won ($1.05) with a pair of Tens



PokerStars Zoom Hand #236523583011:  Hold'em No Limit ($0.25/$0.50) - 2022/06/02 14:57:11 ET
Table 'C Carinae' 2-max Seat #1 is the button
Seat 1: candonga ($59.45 in chips) 
Seat 2: Lorpugo ($22.80 in chips) 
candonga: posts small blind $0.25
Lorpugo: posts big blind $0.50
*** HOLE CARDS ***
Dealt to Lorpugo [As 3h]
candonga: folds 
Uncalled bet ($0.25) returned to Lorpugo
Lorpugo collected $0.50 from pot
Lorpugo: doesn't show hand 
*** SUMMARY ***
Total pot $0.50 | Rake $0 
Seat 1: candonga (button) (small blind) folded before Flop
Seat 2: Lorpugo (big blind) collected ($0.50)



PokerStars Zoom Hand #236523584986:  Hold'em No Limit ($0.25/$0.50) - 2022/06/02 14:57:18 ET
Table 'C Carinae' 2-max Seat #1 is the button
Seat 1: Lorpugo ($23.05 in chips) 
Seat 2: Szar448 ($56.36 in chips) 
Lorpugo: posts small blind $0.25
Szar448: posts big blind $0.50
*** HOLE CARDS ***
Dealt to Lorpugo [9s Tc]
Lorpugo: raises $0.60 to $1.10
Szar448: raises $55.26 to $56.36 and is all-in
Lorpugo: folds 
Uncalled bet ($55.26) returned to Szar448
Szar448 collected $2.20 from pot
Szar448: doesn't show hand 
*** SUMMARY ***
Total pot $2.20 | Rake $0 
Seat 1: Lorpugo (button) (small blind) folded before Flop
Seat 2: Szar448 (big blind) collected ($2.20)



PokerStars Zoom Hand #236523590059:  Hold'em No Limit ($0.25/$0.50) - 2022/06/02 14:57:37 ET
Table 'C Carinae' 2-max Seat #1 is the button
Seat 1: friediii11 ($51.10 in chips) 
Seat 2: Lorpugo ($21.95 in chips) 
friediii11: posts small blind $0.25
Lorpugo: posts big blind $0.50
*** HOLE CARDS ***
Dealt to Lorpugo [6s Ks]
friediii11: raises $0.75 to $1.25
Lorpugo: calls $0.75
*** FLOP *** [9c Jd 3c]
Lorpugo: checks 
friediii11: bets $0.79
Lorpugo: folds 
Uncalled bet ($0.79) returned to friediii11
friediii11 collected $2.35 from pot
friediii11: doesn't show hand 
*** SUMMARY ***
Total pot $2.50 | Rake $0.15 
Board [9c Jd 3c]
Seat 1: friediii11 (button) (small blind) collected ($2.35)
Seat 2: Lorpugo (big blind) folded on the Flop



PokerStars Zoom Hand #236523597117:  Hold'em No Limit ($0.25/$0.50) - 2022/06/02 14:58:04 ET
Table 'C Carinae' 2-max Seat #1 is the button
Seat 1: Lorpugo ($20.70 in chips) 
Seat 2: tanata932 ($66.06 in chips) 
Lorpugo: posts small blind $0.25
tanata932: posts big blind $0.50
*** HOLE CARDS ***
Dealt to Lorpugo [3h 3c]
Lorpugo: raises $0.60 to $1.10
tanata932: calls $0.60
*** FLOP *** [5d 8d Jh]
tanata932: checks 
Lorpugo: checks 
*** TURN *** [5d 8d Jh] [6d]
tanata932: checks 
Lorpugo: checks 
*** RIVER *** [5d 8d Jh 6d] [Ks]
tanata932: checks 
Lorpugo: checks 
*** SHOW DOWN ***
tanata932: shows [As 9d] (high card Ace)
Lorpugo: shows [3h 3c] (a pair of Threes)
Lorpugo collected $2.09 from pot
*** SUMMARY ***
Total pot $2.20 | Rake $0.11 
Board [5d 8d Jh 6d Ks]
Seat 1: Lorpugo (button) (small blind) showed [3h 3c] and won ($2.09) with a pair of Threes
Seat 2: tanata932 (big blind) showed [As 9d] and lost with high card Ace



PokerStars Zoom Hand #236523610387:  Hold'em No Limit ($0.25/$0.50) - 2022/06/02 14:58:51 ET
Table 'C Carinae' 2-max Seat #1 is the button
Seat 1: friediii11 ($201.86 in chips) 
Seat 2: Lorpugo ($21.69 in chips) 
friediii11: posts small blind $0.25
Lorpugo: posts big blind $0.50
*** HOLE CARDS ***
Dealt to Lorpugo [Qs 7h]
friediii11: raises $0.75 to $1.25
Lorpugo: calls $0.75
*** FLOP *** [Ad Ac 5s]
Lorpugo: checks 
friediii11: checks 
*** TURN *** [Ad Ac 5s] [Ks]
Lorpugo: checks 
friediii11: bets $1.79
Lorpugo: calls $1.79
*** RIVER *** [Ad Ac 5s Ks] [8c]
Lorpugo: checks 
friediii11: checks 
*** SHOW DOWN ***
Lorpugo: shows [Qs 7h] (a pair of Aces)
friediii11: mucks hand 
Lorpugo collected $5.78 from pot
*** SUMMARY ***
Total pot $6.08 | Rake $0.30 
Board [Ad Ac 5s Ks 8c]
Seat 1: friediii11 (button) (small blind) mucked [6h 7c]
Seat 2: Lorpugo (big blind) showed [Qs 7h] and won ($5.78) with a pair of Aces



PokerStars Zoom Hand #236523618629:  Hold'em No Limit ($0.25/$0.50) - 2022/06/02 14:59:22 ET
Table 'C Carinae' 2-max Seat #1 is the button
Seat 1: Lorpugo ($24.43 in chips) 
Seat 2: friediii11 ($198.82 in chips) 
Lorpugo: posts small blind $0.25
friediii11: posts big blind $0.50
*** HOLE CARDS ***
Dealt to Lorpugo [6d Tc]
Lorpugo: raises $0.50 to $1
friediii11: folds 
Uncalled bet ($0.50) returned to Lorpugo
Lorpugo collected $1 from pot
Lorpugo: doesn't show hand 
*** SUMMARY ***
Total pot $1 | Rake $0 
Seat 1: Lorpugo (button) (small blind) collected ($1)
Seat 2: friediii11 (big blind) folded before Flop



PokerStars Zoom Hand #236523620802:  Hold'em No Limit ($0.25/$0.50) - 2022/06/02 14:59:30 ET
Table 'C Carinae' 2-max Seat #1 is the button
Seat 1: friediii11 ($198.32 in chips) 
Seat 2: Lorpugo ($24.93 in chips) 
friediii11: posts small blind $0.25
Lorpugo: posts big blind $0.50
*** HOLE CARDS ***
Dealt to Lorpugo [3c Jh]
friediii11: raises $0.75 to $1.25
Lorpugo: folds 
Uncalled bet ($0.75) returned to friediii11
friediii11 collected $1 from pot
friediii11: doesn't show hand 
*** SUMMARY ***
Total pot $1 | Rake $0 
Seat 1: friediii11 (button) (small blind) collected ($1)
Seat 2: Lorpugo (big blind) folded before Flop



PokerStars Zoom Hand #236523623343:  Hold'em No Limit ($0.25/$0.50) - 2022/06/02 14:59:40 ET
Table 'C Carinae' 2-max Seat #1 is the button
Seat 1: Lorpugo ($24.43 in chips) 
Seat 2: Szar448 ($50.49 in chips) 
Lorpugo: posts small blind $0.25
Szar448: posts big blind $0.50
*** HOLE CARDS ***
Dealt to Lorpugo [4d 2s]
Lorpugo: folds 
Uncalled bet ($0.25) returned to Szar448
Szar448 collected $0.50 from pot
Szar448: doesn't show hand 
*** SUMMARY ***
Total pot $0.50 | Rake $0 
Seat 1: Lorpugo (button) (small blind) folded before Flop
Seat 2: Szar448 (big blind) collected ($0.50)



PokerStars Zoom Hand #236523625179:  Hold'em No Limit ($0.25/$0.50) - 2022/06/02 14:59:47 ET
Table 'C Carinae' 2-max Seat #1 is the button
Seat 1: Seepferdi ($28.72 in chips) 
Seat 2: Lorpugo ($24.18 in chips) 
Seepferdi: posts small blind $0.25
Lorpugo: posts big blind $0.50
*** HOLE CARDS ***
Dealt to Lorpugo [4d 5s]
Seepferdi: raises $0.50 to $1
Lorpugo: calls $0.50
*** FLOP *** [3d 6d 8h]
Lorpugo: checks 
Seepferdi: bets $1.52
Lorpugo: calls $1.52
*** TURN *** [3d 6d 8h] [2h]
Lorpugo: checks 
Seepferdi: checks 
*** RIVER *** [3d 6d 8h 2h] [Kd]
Lorpugo: bets $2
Seepferdi: folds 
Uncalled bet ($2) returned to Lorpugo
Lorpugo collected $4.79 from pot
Lorpugo: doesn't show hand 
*** SUMMARY ***
Total pot $5.04 | Rake $0.25 
Board [3d 6d 8h 2h Kd]
Seat 1: Seepferdi (button) (small blind) folded on the River
Seat 2: Lorpugo (big blind) collected ($4.79)



PokerStars Zoom Hand #236523636520:  Hold'em No Limit ($0.25/$0.50) - 2022/06/02 15:00:29 ET
Table 'C Carinae' 2-max Seat #1 is the button
Seat 1: Lorpugo ($26.45 in chips) 
Seat 2: Poker4k1 ($54.39 in chips) 
Lorpugo: posts small blind $0.25
Poker4k1: posts big blind $0.50
*** HOLE CARDS ***
Dealt to Lorpugo [8h Qc]
Lorpugo: raises $0.60 to $1.10
Poker4k1: calls $0.60
*** FLOP *** [5s 9s 4h]
Poker4k1: checks 
Lorpugo: bets $0.69
Poker4k1: folds 
Uncalled bet ($0.69) returned to Lorpugo
Lorpugo collected $2.09 from pot
Lorpugo: doesn't show hand 
*** SUMMARY ***
Total pot $2.20 | Rake $0.11 
Board [5s 9s 4h]
Seat 1: Lorpugo (button) (small blind) collected ($2.09)
Seat 2: Poker4k1 (big blind) folded on the Flop



PokerStars Zoom Hand #236523645278:  Hold'em No Limit ($0.25/$0.50) - 2022/06/02 15:00:59 ET
Table 'C Carinae' 2-max Seat #1 is the button
Seat 1: Poker4k1 ($53.29 in chips) 
Seat 2: Lorpugo ($27.44 in chips) 
Poker4k1: posts small blind $0.25
Lorpugo: posts big blind $0.50
*** HOLE CARDS ***
Dealt to Lorpugo [3h 8s]
Poker4k1: raises $0.75 to $1.25
Lorpugo: folds 
Uncalled bet ($0.75) returned to Poker4k1
Poker4k1 collected $1 from pot
Poker4k1: doesn't show hand 
*** SUMMARY ***
Total pot $1 | Rake $0 
Seat 1: Poker4k1 (button) (small blind) collected ($1)
Seat 2: Lorpugo (big blind) folded before Flop



PokerStars Zoom Hand #236523648282:  Hold'em No Limit ($0.25/$0.50) - 2022/06/02 15:01:09 ET
Table 'C Carinae' 2-max Seat #1 is the button
Seat 1: Lorpugo ($26.94 in chips) 
Seat 2: Poker4k1 ($53.79 in chips) 
Lorpugo: posts small blind $0.25
Poker4k1: posts big blind $0.50
*** HOLE CARDS ***
Dealt to Lorpugo [Ad 5c]
Lorpugo: raises $0.60 to $1.10
Poker4k1: calls $0.60
*** FLOP *** [4s 4c 2c]
Poker4k1: checks 
Lorpugo: bets $0.69
Poker4k1: folds 
Uncalled bet ($0.69) returned to Lorpugo
Lorpugo collected $2.09 from pot
Lorpugo: doesn't show hand 
*** SUMMARY ***
Total pot $2.20 | Rake $0.11 
Board [4s 4c 2c]
Seat 1: Lorpugo (button) (small blind) collected ($2.09)
Seat 2: Poker4k1 (big blind) folded on the Flop



PokerStars Zoom Hand #236523654627:  Hold'em No Limit ($0.25/$0.50) - 2022/06/02 15:01:29 ET
Table 'C Carinae' 2-max Seat #1 is the button
Seat 1: QuakieMan ($109.82 in chips) 
Seat 2: Lorpugo ($27.93 in chips) 
QuakieMan: posts small blind $0.25
Lorpugo: posts big blind $0.50
*** HOLE CARDS ***
Dealt to Lorpugo [7c 7d]
QuakieMan: raises $0.52 to $1.02
Lorpugo: calls $0.52
*** FLOP *** [2c 5s 7h]
Lorpugo: checks 
QuakieMan: checks 
*** TURN *** [2c 5s 7h] [Ad]
Lorpugo: checks 
QuakieMan: bets $1.01
Lorpugo: raises $1.98 to $2.99
QuakieMan: folds 
Uncalled bet ($1.98) returned to Lorpugo
Lorpugo collected $3.86 from pot
Lorpugo: doesn't show hand 
*** SUMMARY ***
Total pot $4.06 | Rake $0.20 
Board [2c 5s 7h Ad]
Seat 1: QuakieMan (button) (small blind) folded on the Turn
Seat 2: Lorpugo (big blind) collected ($3.86)



PokerStars Zoom Hand #236523664129:  Hold'em No Limit ($0.25/$0.50) - 2022/06/02 15:01:58 ET
Table 'C Carinae' 2-max Seat #1 is the button
Seat 1: Lorpugo ($29.76 in chips) 
Seat 2: KillerSword ($20.49 in chips) 
Lorpugo: posts small blind $0.25
KillerSword: posts big blind $0.50
*** HOLE CARDS ***
Dealt to Lorpugo [3h 4d]
Lorpugo: folds 
Uncalled bet ($0.25) returned to KillerSword
KillerSword collected $0.50 from pot
KillerSword: doesn't show hand 
*** SUMMARY ***
Total pot $0.50 | Rake $0 
Seat 1: Lorpugo (button) (small blind) folded before Flop
Seat 2: KillerSword (big blind) collected ($0.50)



PokerStars Zoom Hand #236523666762:  Hold'em No Limit ($0.25/$0.50) - 2022/06/02 15:02:06 ET
Table 'C Carinae' 2-max Seat #1 is the button
Seat 1: Karadi.Joco28 ($27.37 in chips) 
Seat 2: Lorpugo ($29.51 in chips) 
Karadi.Joco28: posts small blind $0.25
Lorpugo: posts big blind $0.50
*** HOLE CARDS ***
Dealt to Lorpugo [Qd 9c]
Karadi.Joco28: folds 
Uncalled bet ($0.25) returned to Lorpugo
Lorpugo collected $0.50 from pot
Lorpugo: doesn't show hand 
*** SUMMARY ***
Total pot $0.50 | Rake $0 
Seat 1: Karadi.Joco28 (button) (small blind) folded before Flop
Seat 2: Lorpugo (big blind) collected ($0.50)



PokerStars Zoom Hand #236523668756:  Hold'em No Limit ($0.25/$0.50) - 2022/06/02 15:02:12 ET
Table 'C Carinae' 2-max Seat #1 is the button
Seat 1: Lorpugo ($29.76 in chips) 
Seat 2: Karadi.Joco28 ($27.12 in chips) 
Lorpugo: posts small blind $0.25
Karadi.Joco28: posts big blind $0.50
*** HOLE CARDS ***
Dealt to Lorpugo [3s Kd]
Lorpugo: raises $0.60 to $1.10
Karadi.Joco28: calls $0.60
*** FLOP *** [Qs 5d 7s]
Karadi.Joco28: checks 
Lorpugo: bets $0.69
Karadi.Joco28: calls $0.69
*** TURN *** [Qs 5d 7s] [5c]
Karadi.Joco28: bets $1.70
Lorpugo: folds 
Uncalled bet ($1.70) returned to Karadi.Joco28
Karadi.Joco28 collected $3.40 from pot
Karadi.Joco28: doesn't show hand 
*** SUMMARY ***
Total pot $3.58 | Rake $0.18 
Board [Qs 5d 7s 5c]
Seat 1: Lorpugo (button) (small blind) folded on the Turn
Seat 2: Karadi.Joco28 (big blind) collected ($3.40)



PokerStars Zoom Hand #236523677722:  Hold'em No Limit ($0.25/$0.50) - 2022/06/02 15:02:39 ET
Table 'C Carinae' 2-max Seat #1 is the button
Seat 1: Karadi.Joco28 ($28.73 in chips) 
Seat 2: Lorpugo ($27.97 in chips) 
Karadi.Joco28: posts small blind $0.25
Lorpugo: posts big blind $0.50
*** HOLE CARDS ***
Dealt to Lorpugo [4h 5s]
Karadi.Joco28: folds 
Uncalled bet ($0.25) returned to Lorpugo
Lorpugo collected $0.50 from pot
Lorpugo: doesn't show hand 
*** SUMMARY ***
Total pot $0.50 | Rake $0 
Seat 1: Karadi.Joco28 (button) (small blind) folded before Flop
Seat 2: Lorpugo (big blind) collected ($0.50)



PokerStars Zoom Hand #236523679919:  Hold'em No Limit ($0.25/$0.50) - 2022/06/02 15:02:45 ET
Table 'C Carinae' 2-max Seat #1 is the button
Seat 1: Lorpugo ($28.22 in chips) 
Seat 2: Limerickey71 ($30.34 in chips) 
Lorpugo: posts small blind $0.25
Limerickey71: posts big blind $0.50
*** HOLE CARDS ***
Dealt to Lorpugo [2d 6h]
Lorpugo: folds 
Uncalled bet ($0.25) returned to Limerickey71
Limerickey71 collected $0.50 from pot
Limerickey71: doesn't show hand 
*** SUMMARY ***
Total pot $0.50 | Rake $0 
Seat 1: Lorpugo (button) (small blind) folded before Flop
Seat 2: Limerickey71 (big blind) collected ($0.50)



PokerStars Zoom Hand #236523682578:  Hold'em No Limit ($0.25/$0.50) - 2022/06/02 15:02:52 ET
Table 'C Carinae' 2-max Seat #1 is the button
Seat 1: 11DaMandem11 ($39.67 in chips) 
Seat 2: Lorpugo ($27.97 in chips) 
11DaMandem11: posts small blind $0.25
Lorpugo: posts big blind $0.50
*** HOLE CARDS ***
Dealt to Lorpugo [Tc 2s]
11DaMandem11: raises $0.50 to $1
Lorpugo: folds 
Uncalled bet ($0.50) returned to 11DaMandem11
11DaMandem11 collected $1 from pot
11DaMandem11: doesn't show hand 
*** SUMMARY ***
Total pot $1 | Rake $0 
Seat 1: 11DaMandem11 (button) (small blind) collected ($1)
Seat 2: Lorpugo (big blind) folded before Flop



PokerStars Zoom Hand #236523691185:  Hold'em No Limit ($0.25/$0.50) - 2022/06/02 15:03:03 ET
Table 'C Carinae' 2-max Seat #1 is the button
Seat 1: Poker4k1 ($57.32 in chips) 
Seat 2: Lorpugo ($27.47 in chips) 
Poker4k1: posts small blind $0.25
Lorpugo: posts big blind $0.50
*** HOLE CARDS ***
Dealt to Lorpugo [6c Ks]
Poker4k1: raises $0.75 to $1.25
Lorpugo: calls $0.75
*** FLOP *** [8s 9c 4c]
Lorpugo: checks 
Poker4k1: checks 
*** TURN *** [8s 9c 4c] [Qd]
Lorpugo: checks 
Poker4k1: bets $1.25
Lorpugo: folds 
Uncalled bet ($1.25) returned to Poker4k1
Poker4k1 collected $2.38 from pot
Poker4k1: doesn't show hand 
*** SUMMARY ***
Total pot $2.50 | Rake $0.12 
Board [8s 9c 4c Qd]
Seat 1: Poker4k1 (button) (small blind) collected ($2.38)
Seat 2: Lorpugo (big blind) folded on the Turn



PokerStars Zoom Hand #236523707279:  Hold'em No Limit ($0.25/$0.50) - 2022/06/02 15:03:49 ET
Table 'C Carinae' 2-max Seat #1 is the button
Seat 1: Lorpugo ($26.22 in chips) 
Seat 2: QuakieMan ($109.52 in chips) 
Lorpugo: posts small blind $0.25
QuakieMan: posts big blind $0.50
*** HOLE CARDS ***
Dealt to Lorpugo [7h Qc]
Lorpugo: raises $0.60 to $1.10
QuakieMan: folds 
Uncalled bet ($0.60) returned to Lorpugo
Lorpugo collected $1 from pot
Lorpugo: doesn't show hand 
*** SUMMARY ***
Total pot $1 | Rake $0 
Seat 1: Lorpugo (button) (small blind) collected ($1)
Seat 2: QuakieMan (big blind) folded before Flop



PokerStars Zoom Hand #236523711229:  Hold'em No Limit ($0.25/$0.50) - 2022/06/02 15:04:00 ET
Table 'C Carinae' 2-max Seat #1 is the button
Seat 1: Lorpugo ($26.72 in chips) 
Seat 2: QuakieMan ($109.02 in chips) 
Lorpugo: posts small blind $0.25
QuakieMan: posts big blind $0.50
*** HOLE CARDS ***
Dealt to Lorpugo [8c 7c]
Lorpugo: raises $0.60 to $1.10
QuakieMan: folds 
Uncalled bet ($0.60) returned to Lorpugo
Lorpugo collected $1 from pot
Lorpugo: doesn't show hand 
*** SUMMARY ***
Total pot $1 | Rake $0 
Seat 1: Lorpugo (button) (small blind) collected ($1)
Seat 2: QuakieMan (big blind) folded before Flop



PokerStars Zoom Hand #236523717784:  Hold'em No Limit ($0.25/$0.50) - 2022/06/02 15:04:19 ET
Table 'C Carinae' 2-max Seat #1 is the button
Seat 1: Limerickey71 ($21.71 in chips) 
Seat 2: Lorpugo ($27.22 in chips) 
Limerickey71: posts small blind $0.25
Lorpugo: posts big blind $0.50
*** HOLE CARDS ***
Dealt to Lorpugo [Ad 9h]
Limerickey71: raises $0.50 to $1
Lorpugo: raises $2.50 to $3.50
Limerickey71: calls $2.50
*** FLOP *** [9c 4c 7c]
Lorpugo: bets $23.72 and is all-in
Limerickey71: calls $18.21 and is all-in
Uncalled bet ($5.51) returned to Lorpugo
*** TURN *** [9c 4c 7c] [Td]
*** RIVER *** [9c 4c 7c Td] [2d]
*** SHOW DOWN ***
Lorpugo: shows [Ad 9h] (a pair of Nines)
Limerickey71: shows [4d 7d] (two pair, Sevens and Fours)
Limerickey71 collected $42.67 from pot
*** SUMMARY ***
Total pot $43.42 | Rake $0.75 
Board [9c 4c 7c Td 2d]
Seat 1: Limerickey71 (button) (small blind) showed [4d 7d] and won ($42.67) with two pair, Sevens and Fours
Seat 2: Lorpugo (big blind) showed [Ad 9h] and lost with a pair of Nines



PokerStars Zoom Hand #236523727416:  Hold'em No Limit ($0.25/$0.50) - 2022/06/02 15:04:46 ET
Table 'C Carinae' 2-max Seat #1 is the button
Seat 1: Lorpugo ($5.51 in chips) 
Seat 2: candonga ($56.01 in chips) 
Lorpugo: posts small blind $0.25
candonga: posts big blind $0.50
*** HOLE CARDS ***
Dealt to Lorpugo [Ac Tc]
Lorpugo: raises $5.01 to $5.51 and is all-in
candonga: calls $5.01
*** FLOP *** [Qc 7c Qd]
*** TURN *** [Qc 7c Qd] [8s]
*** RIVER *** [Qc 7c Qd 8s] [3d]
*** SHOW DOWN ***
candonga: shows [As 7s] (two pair, Queens and Sevens)
Lorpugo: shows [Ac Tc] (a pair of Queens)
candonga collected $10.47 from pot
*** SUMMARY ***
Total pot $11.02 | Rake $0.55 
Board [Qc 7c Qd 8s 3d]
Seat 1: Lorpugo (button) (small blind) showed [Ac Tc] and lost with a pair of Queens
Seat 2: candonga (big blind) showed [As 7s] and won ($10.47) with two pair, Queens and Sevens



PokerStars Zoom Hand #236523738223:  Hold'em No Limit ($0.25/$0.50) - 2022/06/02 15:05:15 ET
Table 'C Carinae' 2-max Seat #1 is the button
Seat 1: friediii11 ($224.24 in chips) 
Seat 2: Lorpugo ($38.53 in chips) 
friediii11: posts small blind $0.25
Lorpugo: posts big blind $0.50
*** HOLE CARDS ***
Dealt to Lorpugo [Ah Kh]
friediii11: raises $0.75 to $1.25
Lorpugo: raises $3.25 to $4.50
friediii11: folds 
Uncalled bet ($3.25) returned to Lorpugo
Lorpugo collected $2.50 from pot
Lorpugo: doesn't show hand 
*** SUMMARY ***
Total pot $2.50 | Rake $0 
Seat 1: friediii11 (button) (small blind) folded before Flop
Seat 2: Lorpugo (big blind) collected ($2.50)



PokerStars Zoom Hand #236523743377:  Hold'em No Limit ($0.25/$0.50) - 2022/06/02 15:05:30 ET
Table 'C Carinae' 2-max Seat #1 is the button
Seat 1: Lorpugo ($39.78 in chips) 
Seat 2: tanata932 ($81.93 in chips) 
Lorpugo: posts small blind $0.25
tanata932: posts big blind $0.50
*** HOLE CARDS ***
Dealt to Lorpugo [8s 2h]
Lorpugo: folds 
Uncalled bet ($0.25) returned to tanata932
tanata932 collected $0.50 from pot
tanata932: doesn't show hand 
*** SUMMARY ***
Total pot $0.50 | Rake $0 
Seat 1: Lorpugo (button) (small blind) folded before Flop
Seat 2: tanata932 (big blind) collected ($0.50)



PokerStars Zoom Hand #236523746317:  Hold'em No Limit ($0.25/$0.50) - 2022/06/02 15:05:38 ET
Table 'C Carinae' 2-max Seat #1 is the button
Seat 1: candonga ($61.82 in chips) 
Seat 2: Lorpugo ($39.53 in chips) 
candonga: posts small blind $0.25
Lorpugo: posts big blind $0.50
*** HOLE CARDS ***
Dealt to Lorpugo [9c 5h]
candonga: raises $1 to $1.50
Lorpugo: folds 
Uncalled bet ($1) returned to candonga
candonga collected $1 from pot
candonga: doesn't show hand 
*** SUMMARY ***
Total pot $1 | Rake $0 
Seat 1: candonga (button) (small blind) collected ($1)
Seat 2: Lorpugo (big blind) folded before Flop



PokerStars Zoom Hand #236523750862:  Hold'em No Limit ($0.25/$0.50) - 2022/06/02 15:05:50 ET
Table 'C Carinae' 2-max Seat #1 is the button
Seat 1: Lorpugo ($39.03 in chips) 
Seat 2: rotnem78 ($54.37 in chips) 
Lorpugo: posts small blind $0.25
rotnem78: posts big blind $0.50
*** HOLE CARDS ***
Dealt to Lorpugo [9d 7h]
Lorpugo: raises $0.60 to $1.10
rotnem78: calls $0.60
*** FLOP *** [4d 2h Kh]
rotnem78: checks 
Lorpugo: bets $0.69
rotnem78: calls $0.69
*** TURN *** [4d 2h Kh] [Jh]
rotnem78: checks 
Lorpugo: checks 
*** RIVER *** [4d 2h Kh Jh] [Ad]
rotnem78: bets $5
Lorpugo: folds 
Uncalled bet ($5) returned to rotnem78
rotnem78 collected $3.36 from pot
rotnem78: doesn't show hand 
*** SUMMARY ***
Total pot $3.58 | Rake $0.22 
Board [4d 2h Kh Jh Ad]
Seat 1: Lorpugo (button) (small blind) folded on the River
Seat 2: rotnem78 (big blind) collected ($3.36)



PokerStars Zoom Hand #236523761958:  Hold'em No Limit ($0.25/$0.50) - 2022/06/02 15:06:21 ET
Table 'C Carinae' 2-max Seat #1 is the button
Seat 1: Karadi.Joco28 ($22.11 in chips) 
Seat 2: Lorpugo ($37.24 in chips) 
Karadi.Joco28: posts small blind $0.25
Lorpugo: posts big blind $0.50
*** HOLE CARDS ***
Dealt to Lorpugo [4s 3c]
Karadi.Joco28: calls $0.25
Lorpugo: checks 
*** FLOP *** [6h 2h 9c]
Lorpugo: checks 
Karadi.Joco28: checks 
*** TURN *** [6h 2h 9c] [Kc]
Lorpugo: checks 
Karadi.Joco28: bets $0.50
Lorpugo: raises $0.98 to $1.48
Karadi.Joco28: calls $0.98
*** RIVER *** [6h 2h 9c Kc] [4c]
Lorpugo: checks 
Karadi.Joco28: checks 
*** SHOW DOWN ***
Lorpugo: shows [4s 3c] (a pair of Fours)
Karadi.Joco28: shows [Ah Kd] (a pair of Kings)
Karadi.Joco28 collected $3.76 from pot
*** SUMMARY ***
Total pot $3.96 | Rake $0.20 
Board [6h 2h 9c Kc 4c]
Seat 1: Karadi.Joco28 (button) (small blind) showed [Ah Kd] and won ($3.76) with a pair of Kings
Seat 2: Lorpugo (big blind) showed [4s 3c] and lost with a pair of Fours



PokerStars Zoom Hand #236523783808:  Hold'em No Limit ($0.25/$0.50) - 2022/06/02 15:07:20 ET
Table 'C Carinae' 2-max Seat #1 is the button
Seat 1: Lorpugo ($35.26 in chips) 
Seat 2: Karadi.Joco28 ($23.89 in chips) 
Lorpugo: posts small blind $0.25
Karadi.Joco28: posts big blind $0.50
*** HOLE CARDS ***
Dealt to Lorpugo [5c 8s]
Lorpugo: raises $0.50 to $1
Karadi.Joco28: calls $0.50
*** FLOP *** [Kd 9h 4c]
Karadi.Joco28: checks 
Lorpugo: bets $0.95
Karadi.Joco28: calls $0.95
*** TURN *** [Kd 9h 4c] [Ac]
Karadi.Joco28: checks 
Lorpugo: bets $1.22
Karadi.Joco28: calls $1.22
*** RIVER *** [Kd 9h 4c Ac] [2s]
Karadi.Joco28: checks 
Lorpugo: checks 
*** SHOW DOWN ***
Karadi.Joco28: shows [Ts Qd] (high card Ace)
Lorpugo: mucks hand 
Karadi.Joco28 collected $6.02 from pot
*** SUMMARY ***
Total pot $6.34 | Rake $0.32 
Board [Kd 9h 4c Ac 2s]
Seat 1: Lorpugo (button) (small blind) mucked [5c 8s]
Seat 2: Karadi.Joco28 (big blind) showed [Ts Qd] and won ($6.02) with high card Ace



PokerStars Zoom Hand #236523796682:  Hold'em No Limit ($0.25/$0.50) - 2022/06/02 15:07:55 ET
Table 'C Carinae' 2-max Seat #1 is the button
Seat 1: Lorpugo ($32.09 in chips) 
Seat 2: candonga ($68.41 in chips) 
Lorpugo: posts small blind $0.25
candonga: posts big blind $0.50
*** HOLE CARDS ***
Dealt to Lorpugo [Qc Ah]
Lorpugo: raises $0.60 to $1.10
candonga: calls $0.60
*** FLOP *** [Jc 9c 6d]
candonga: checks 
Lorpugo: checks 
*** TURN *** [Jc 9c 6d] [5s]
candonga: checks 
Lorpugo: checks 
*** RIVER *** [Jc 9c 6d 5s] [8c]
candonga: checks 
Lorpugo: checks 
*** SHOW DOWN ***
candonga: shows [Ks 3h] (high card King)
Lorpugo: shows [Qc Ah] (high card Ace)
Lorpugo collected $2.09 from pot
*** SUMMARY ***
Total pot $2.20 | Rake $0.11 
Board [Jc 9c 6d 5s 8c]
Seat 1: Lorpugo (button) (small blind) showed [Qc Ah] and won ($2.09) with high card Ace
Seat 2: candonga (big blind) showed [Ks 3h] and lost with high card King



PokerStars Zoom Hand #236523808124:  Hold'em No Limit ($0.25/$0.50) - 2022/06/02 15:08:27 ET
Table 'C Carinae' 2-max Seat #1 is the button
Seat 1: candonga ($67.31 in chips) 
Seat 2: Lorpugo ($33.08 in chips) 
candonga: posts small blind $0.25
Lorpugo: posts big blind $0.50
*** HOLE CARDS ***
Dealt to Lorpugo [4h 6s]
candonga: raises $1 to $1.50
Lorpugo: folds 
Uncalled bet ($1) returned to candonga
candonga collected $1 from pot
candonga: doesn't show hand 
*** SUMMARY ***
Total pot $1 | Rake $0 
Seat 1: candonga (button) (small blind) collected ($1)
Seat 2: Lorpugo (big blind) folded before Flop



PokerStars Zoom Hand #236523811519:  Hold'em No Limit ($0.25/$0.50) - 2022/06/02 15:08:36 ET
Table 'C Carinae' 2-max Seat #1 is the button
Seat 1: friediii11 ($80.60 in chips) 
Seat 2: Lorpugo ($32.58 in chips) 
friediii11: posts small blind $0.25
Lorpugo: posts big blind $0.50
*** HOLE CARDS ***
Dealt to Lorpugo [7d 2s]
friediii11: raises $0.75 to $1.25
Lorpugo: folds 
Uncalled bet ($0.75) returned to friediii11
friediii11 collected $1 from pot
friediii11: doesn't show hand 
*** SUMMARY ***
Total pot $1 | Rake $0 
Seat 1: friediii11 (button) (small blind) collected ($1)
Seat 2: Lorpugo (big blind) folded before Flop



PokerStars Zoom Hand #236523817625:  Hold'em No Limit ($0.25/$0.50) - 2022/06/02 15:08:52 ET
Table 'C Carinae' 2-max Seat #1 is the button
Seat 1: Lorpugo ($32.08 in chips) 
Seat 2: Karadi.Joco28 ($15.58 in chips) 
Lorpugo: posts small blind $0.25
Karadi.Joco28: posts big blind $0.50
*** HOLE CARDS ***
Dealt to Lorpugo [Qs 7c]
Lorpugo: raises $0.60 to $1.10
Karadi.Joco28: folds 
Uncalled bet ($0.60) returned to Lorpugo
Lorpugo collected $1 from pot
Lorpugo: doesn't show hand 
*** SUMMARY ***
Total pot $1 | Rake $0 
Seat 1: Lorpugo (button) (small blind) collected ($1)
Seat 2: Karadi.Joco28 (big blind) folded before Flop



PokerStars Zoom Hand #236523821607:  Hold'em No Limit ($0.25/$0.50) - 2022/06/02 15:09:03 ET
Table 'C Carinae' 2-max Seat #1 is the button
Seat 1: Lorpugo ($32.58 in chips) 
Seat 2: fabsee1 ($104.88 in chips) 
Lorpugo: posts small blind $0.25
fabsee1: posts big blind $0.50
*** HOLE CARDS ***
Dealt to Lorpugo [4d Qc]
Lorpugo: raises $0.60 to $1.10
fabsee1: raises $3.20 to $4.30
Lorpugo: folds 
Uncalled bet ($3.20) returned to fabsee1
fabsee1 collected $2.20 from pot
fabsee1: doesn't show hand 
*** SUMMARY ***
Total pot $2.20 | Rake $0 
Seat 1: Lorpugo (button) (small blind) folded before Flop
Seat 2: fabsee1 (big blind) collected ($2.20)



PokerStars Zoom Hand #236523827823:  Hold'em No Limit ($0.25/$0.50) - 2022/06/02 15:09:20 ET
Table 'C Carinae' 2-max Seat #1 is the button
Seat 1: fabsee1 ($105.98 in chips) 
Seat 2: Lorpugo ($31.48 in chips) 
fabsee1: posts small blind $0.25
Lorpugo: posts big blind $0.50
*** HOLE CARDS ***
Dealt to Lorpugo [6s 5c]
fabsee1: raises $0.50 to $1
Lorpugo: folds 
Uncalled bet ($0.50) returned to fabsee1
fabsee1 collected $1 from pot
fabsee1: doesn't show hand 
*** SUMMARY ***
Total pot $1 | Rake $0 
Seat 1: fabsee1 (button) (small blind) collected ($1)
Seat 2: Lorpugo (big blind) folded before Flop



PokerStars Zoom Hand #236523833168:  Hold'em No Limit ($0.25/$0.50) - 2022/06/02 15:09:35 ET
Table 'C Carinae' 2-max Seat #1 is the button
Seat 1: friediii11 ($257.82 in chips) 
Seat 2: Lorpugo ($30.98 in chips) 
friediii11: posts small blind $0.25
Lorpugo: posts big blind $0.50
*** HOLE CARDS ***
Dealt to Lorpugo [2h 4s]
friediii11: folds 
Uncalled bet ($0.25) returned to Lorpugo
Lorpugo collected $0.50 from pot
Lorpugo: doesn't show hand 
*** SUMMARY ***
Total pot $0.50 | Rake $0 
Seat 1: friediii11 (button) (small blind) folded before Flop
Seat 2: Lorpugo (big blind) collected ($0.50)



PokerStars Zoom Hand #236523835396:  Hold'em No Limit ($0.25/$0.50) - 2022/06/02 15:09:41 ET
Table 'C Carinae' 2-max Seat #1 is the button
Seat 1: Lorpugo ($31.23 in chips) 
Seat 2: Limerickey71 ($42.93 in chips) 
Lorpugo: posts small blind $0.25
Limerickey71: posts big blind $0.50
*** HOLE CARDS ***
Dealt to Lorpugo [3c 6c]
Lorpugo: raises $0.50 to $1
Limerickey71: folds 
Uncalled bet ($0.50) returned to Lorpugo
Lorpugo collected $1 from pot
Lorpugo: doesn't show hand 
*** SUMMARY ***
Total pot $1 | Rake $0 
Seat 1: Lorpugo (button) (small blind) collected ($1)
Seat 2: Limerickey71 (big blind) folded before Flop



PokerStars Zoom Hand #236523839037:  Hold'em No Limit ($0.25/$0.50) - 2022/06/02 15:09:51 ET
Table 'C Carinae' 2-max Seat #1 is the button
Seat 1: Lorpugo ($31.73 in chips) 
Seat 2: 11DaMandem11 ($20.85 in chips) 
Lorpugo: posts small blind $0.25
11DaMandem11: posts big blind $0.50
*** HOLE CARDS ***
Dealt to Lorpugo [8h Ah]
Lorpugo: raises $0.60 to $1.10
11DaMandem11: calls $0.60
*** FLOP *** [Jh 5c 4s]
11DaMandem11: checks 
Lorpugo: bets $0.69
11DaMandem11: calls $0.69
*** TURN *** [Jh 5c 4s] [7s]
11DaMandem11: checks 
Lorpugo: checks 
*** RIVER *** [Jh 5c 4s 7s] [Ac]
11DaMandem11: bets $2
Lorpugo: raises $5.50 to $7.50
11DaMandem11: calls $5.50
*** SHOW DOWN ***
Lorpugo: shows [8h Ah] (a pair of Aces)
11DaMandem11: mucks hand 
Lorpugo collected $17.83 from pot
*** SUMMARY ***
Total pot $18.58 | Rake $0.75 
Board [Jh 5c 4s 7s Ac]
Seat 1: Lorpugo (button) (small blind) showed [8h Ah] and won ($17.83) with a pair of Aces
Seat 2: 11DaMandem11 (big blind) mucked [7c Td]



PokerStars Zoom Hand #236523854444:  Hold'em No Limit ($0.25/$0.50) - 2022/06/02 15:10:32 ET
Table 'C Carinae' 2-max Seat #1 is the button
Seat 1: Poker4k1 ($51.38 in chips) 
Seat 2: Lorpugo ($40.27 in chips) 
Poker4k1: posts small blind $0.25
Lorpugo: posts big blind $0.50
*** HOLE CARDS ***
Dealt to Lorpugo [Kd 5d]
Poker4k1: folds 
Uncalled bet ($0.25) returned to Lorpugo
Lorpugo collected $0.50 from pot
Lorpugo: doesn't show hand 
*** SUMMARY ***
Total pot $0.50 | Rake $0 
Seat 1: Poker4k1 (button) (small blind) folded before Flop
Seat 2: Lorpugo (big blind) collected ($0.50)



PokerStars Zoom Hand #236523857462:  Hold'em No Limit ($0.25/$0.50) - 2022/06/02 15:10:40 ET
Table 'C Carinae' 2-max Seat #1 is the button
Seat 1: Poker4k1 ($56.18 in chips) 
Seat 2: Lorpugo ($40.52 in chips) 
Poker4k1: posts small blind $0.25
Lorpugo: posts big blind $0.50
*** HOLE CARDS ***
Dealt to Lorpugo [7c 3d]
Poker4k1: raises $0.75 to $1.25
Lorpugo: folds 
Uncalled bet ($0.75) returned to Poker4k1
Poker4k1 collected $1 from pot
Poker4k1: doesn't show hand 
*** SUMMARY ***
Total pot $1 | Rake $0 
Seat 1: Poker4k1 (button) (small blind) collected ($1)
Seat 2: Lorpugo (big blind) folded before Flop



PokerStars Zoom Hand #236523860823:  Hold'em No Limit ($0.25/$0.50) - 2022/06/02 15:10:50 ET
Table 'C Carinae' 2-max Seat #1 is the button
Seat 1: Lorpugo ($40.02 in chips) 
Seat 2: Mtaneli ($189.05 in chips) 
Lorpugo: posts small blind $0.25
Mtaneli: posts big blind $0.50
*** HOLE CARDS ***
Dealt to Lorpugo [3h Qs]
Lorpugo: folds 
Uncalled bet ($0.25) returned to Mtaneli
Mtaneli collected $0.50 from pot
Mtaneli: doesn't show hand 
*** SUMMARY ***
Total pot $0.50 | Rake $0 
Seat 1: Lorpugo (button) (small blind) folded before Flop
Seat 2: Mtaneli (big blind) collected ($0.50)



PokerStars Zoom Hand #236523863734:  Hold'em No Limit ($0.25/$0.50) - 2022/06/02 15:10:58 ET
Table 'C Carinae' 2-max Seat #1 is the button
Seat 1: Lorpugo ($39.77 in chips) 
Seat 2: Poker4k1 ($51.88 in chips) 
Lorpugo: posts small blind $0.25
Poker4k1: posts big blind $0.50
*** HOLE CARDS ***
Dealt to Lorpugo [3s 6d]
Lorpugo: folds 
Uncalled bet ($0.25) returned to Poker4k1
Poker4k1 collected $0.50 from pot
Poker4k1: doesn't show hand 
*** SUMMARY ***
Total pot $0.50 | Rake $0 
Seat 1: Lorpugo (button) (small blind) folded before Flop
Seat 2: Poker4k1 (big blind) collected ($0.50)



PokerStars Zoom Hand #236523866712:  Hold'em No Limit ($0.25/$0.50) - 2022/06/02 15:11:06 ET
Table 'C Carinae' 2-max Seat #1 is the button
Seat 1: idy_hu ($51.31 in chips) 
Seat 2: Lorpugo ($39.52 in chips) 
idy_hu: posts small blind $0.25
Lorpugo: posts big blind $0.50
*** HOLE CARDS ***
Dealt to Lorpugo [Kh Th]
idy_hu: raises $0.75 to $1.25
Lorpugo: calls $0.75
*** FLOP *** [4h As 7s]
Lorpugo: checks 
idy_hu: checks 
*** TURN *** [4h As 7s] [Jc]
Lorpugo: checks 
idy_hu: checks 
*** RIVER *** [4h As 7s Jc] [6c]
Lorpugo: checks 
idy_hu: checks 
*** SHOW DOWN ***
Lorpugo: shows [Kh Th] (high card Ace)
idy_hu: mucks hand 
Lorpugo collected $2.38 from pot
*** SUMMARY ***
Total pot $2.50 | Rake $0.12 
Board [4h As 7s Jc 6c]
Seat 1: idy_hu (button) (small blind) mucked [8c Qd]
Seat 2: Lorpugo (big blind) showed [Kh Th] and won ($2.38) with high card Ace



PokerStars Zoom Hand #236523885051:  Hold'em No Limit ($0.25/$0.50) - 2022/06/02 15:11:55 ET
Table 'C Carinae' 2-max Seat #1 is the button
Seat 1: Mtaneli ($182.39 in chips) 
Seat 2: Lorpugo ($40.65 in chips) 
Mtaneli: posts small blind $0.25
Lorpugo: posts big blind $0.50
*** HOLE CARDS ***
Dealt to Lorpugo [9c 8d]
Mtaneli: raises $0.72 to $1.22
Lorpugo: calls $0.72
*** FLOP *** [Qh Tc 3d]
Lorpugo: checks 
Mtaneli: bets $0.72
Lorpugo: folds 
Uncalled bet ($0.72) returned to Mtaneli
Mtaneli collected $2.32 from pot
Mtaneli: doesn't show hand 
*** SUMMARY ***
Total pot $2.44 | Rake $0.12 
Board [Qh Tc 3d]
Seat 1: Mtaneli (button) (small blind) collected ($2.32)
Seat 2: Lorpugo (big blind) folded on the Flop



PokerStars Zoom Hand #236523896698:  Hold'em No Limit ($0.25/$0.50) - 2022/06/02 15:12:26 ET
Table 'C Carinae' 2-max Seat #1 is the button
Seat 1: Lorpugo ($39.43 in chips) 
Seat 2: candonga ($50 in chips) 
Lorpugo: posts small blind $0.25
candonga: posts big blind $0.50
*** HOLE CARDS ***
Dealt to Lorpugo [9c 2d]
Lorpugo: folds 
Uncalled bet ($0.25) returned to candonga
candonga collected $0.50 from pot
candonga: doesn't show hand 
*** SUMMARY ***
Total pot $0.50 | Rake $0 
Seat 1: Lorpugo (button) (small blind) folded before Flop
Seat 2: candonga (big blind) collected ($0.50)



PokerStars Zoom Hand #236523900384:  Hold'em No Limit ($0.25/$0.50) - 2022/06/02 15:12:37 ET
Table 'C Carinae' 2-max Seat #1 is the button
Seat 1: candonga ($50.25 in chips) 
Seat 2: Lorpugo ($39.18 in chips) 
candonga: posts small blind $0.25
Lorpugo: posts big blind $0.50
*** HOLE CARDS ***
Dealt to Lorpugo [Qs Ks]
candonga: raises $1 to $1.50
Lorpugo: raises $3 to $4.50
candonga: calls $3
*** FLOP *** [Qh Js Qc]
Lorpugo: bets $4.27
candonga: calls $4.27
*** TURN *** [Qh Js Qc] [Jh]
Lorpugo: bets $7
candonga: folds 
Uncalled bet ($7) returned to Lorpugo
Lorpugo collected $16.79 from pot
Lorpugo: doesn't show hand 
*** SUMMARY ***
Total pot $17.54 | Rake $0.75 
Board [Qh Js Qc Jh]
Seat 1: candonga (button) (small blind) folded on the Turn
Seat 2: Lorpugo (big blind) collected ($16.79)



PokerStars Zoom Hand #236523918560:  Hold'em No Limit ($0.25/$0.50) - 2022/06/02 15:13:26 ET
Table 'C Carinae' 2-max Seat #1 is the button
Seat 1: Lorpugo ($47.20 in chips) 
Seat 2: candonga ($50 in chips) 
Lorpugo: posts small blind $0.25
candonga: posts big blind $0.50
*** HOLE CARDS ***
Dealt to Lorpugo [5c 3s]
Lorpugo: folds 
Uncalled bet ($0.25) returned to candonga
candonga collected $0.50 from pot
candonga: doesn't show hand 
*** SUMMARY ***
Total pot $0.50 | Rake $0 
Seat 1: Lorpugo (button) (small blind) folded before Flop
Seat 2: candonga (big blind) collected ($0.50)



PokerStars Zoom Hand #236523921944:  Hold'em No Limit ($0.25/$0.50) - 2022/06/02 15:13:35 ET
Table 'C Carinae' 2-max Seat #1 is the button
Seat 1: Lorpugo ($46.95 in chips) 
Seat 2: candonga ($50.25 in chips) 
Lorpugo: posts small blind $0.25
candonga: posts big blind $0.50
*** HOLE CARDS ***
Dealt to Lorpugo [9s 9c]
Lorpugo: raises $0.60 to $1.10
candonga: raises $4.90 to $6
Lorpugo: raises $40.95 to $46.95 and is all-in
candonga: folds 
Uncalled bet ($40.95) returned to Lorpugo
Lorpugo collected $12 from pot
Lorpugo: doesn't show hand 
*** SUMMARY ***
Total pot $12 | Rake $0 
Seat 1: Lorpugo (button) (small blind) collected ($12)
Seat 2: candonga (big blind) folded before Flop



PokerStars Zoom Hand #236523929303:  Hold'em No Limit ($0.25/$0.50) - 2022/06/02 15:13:55 ET
Table 'C Carinae' 2-max Seat #1 is the button
Seat 1: 11DaMandem11 ($19.72 in chips) 
Seat 2: Lorpugo ($52.95 in chips) 
11DaMandem11: posts small blind $0.25
Lorpugo: posts big blind $0.50
*** HOLE CARDS ***
Dealt to Lorpugo [2d 2h]
11DaMandem11: calls $0.25
Lorpugo: checks 
*** FLOP *** [6d 6c 9c]
Lorpugo: checks 
11DaMandem11: checks 
*** TURN *** [6d 6c 9c] [5h]
Lorpugo: bets $0.50
11DaMandem11: calls $0.50
*** RIVER *** [6d 6c 9c 5h] [Qh]
Lorpugo: bets $0.50
11DaMandem11: calls $0.50
*** SHOW DOWN ***
Lorpugo: shows [2d 2h] (two pair, Sixes and Deuces)
11DaMandem11: mucks hand 
Lorpugo collected $2.85 from pot
*** SUMMARY ***
Total pot $3 | Rake $0.15 
Board [6d 6c 9c 5h Qh]
Seat 1: 11DaMandem11 (button) (small blind) mucked [Td 2s]
Seat 2: Lorpugo (big blind) showed [2d 2h] and won ($2.85) with two pair, Sixes and Deuces



PokerStars Zoom Hand #236523940265:  Hold'em No Limit ($0.25/$0.50) - 2022/06/02 15:14:24 ET
Table 'C Carinae' 2-max Seat #1 is the button
Seat 1: Lorpugo ($54.30 in chips) 
Seat 2: 11DaMandem11 ($18.22 in chips) 
Lorpugo: posts small blind $0.25
11DaMandem11: posts big blind $0.50
*** HOLE CARDS ***
Dealt to Lorpugo [3s 6h]
Lorpugo: folds 
Uncalled bet ($0.25) returned to 11DaMandem11
11DaMandem11 collected $0.50 from pot
11DaMandem11: doesn't show hand 
*** SUMMARY ***
Total pot $0.50 | Rake $0 
Seat 1: Lorpugo (button) (small blind) folded before Flop
Seat 2: 11DaMandem11 (big blind) collected ($0.50)



PokerStars Zoom Hand #236523943514:  Hold'em No Limit ($0.25/$0.50) - 2022/06/02 15:14:33 ET
Table 'C Carinae' 2-max Seat #1 is the button
Seat 1: friediii11 ($139.30 in chips) 
Seat 2: Lorpugo ($54.05 in chips) 
friediii11: posts small blind $0.25
Lorpugo: posts big blind $0.50
*** HOLE CARDS ***
Dealt to Lorpugo [8d Kc]
friediii11: raises $0.75 to $1.25
Lorpugo: calls $0.75
*** FLOP *** [6s Tc As]
Lorpugo: checks 
friediii11: bets $5
Lorpugo: folds 
Uncalled bet ($5) returned to friediii11
friediii11 collected $2.35 from pot
friediii11: doesn't show hand 
*** SUMMARY ***
Total pot $2.50 | Rake $0.15 
Board [6s Tc As]
Seat 1: friediii11 (button) (small blind) collected ($2.35)
Seat 2: Lorpugo (big blind) folded on the Flop



PokerStars Zoom Hand #236523953318:  Hold'em No Limit ($0.25/$0.50) - 2022/06/02 15:14:59 ET
Table 'C Carinae' 2-max Seat #1 is the button
Seat 1: Lorpugo ($52.80 in chips) 
Seat 2: friediii11 ($140.40 in chips) 
Lorpugo: posts small blind $0.25
friediii11: posts big blind $0.50
*** HOLE CARDS ***
Dealt to Lorpugo [6c 8d]
Lorpugo: raises $0.50 to $1
friediii11: folds 
Uncalled bet ($0.50) returned to Lorpugo
Lorpugo collected $1 from pot
Lorpugo: doesn't show hand 
*** SUMMARY ***
Total pot $1 | Rake $0 
Seat 1: Lorpugo (button) (small blind) collected ($1)
Seat 2: friediii11 (big blind) folded before Flop



PokerStars Zoom Hand #236523956784:  Hold'em No Limit ($0.25/$0.50) - 2022/06/02 15:15:08 ET
Table 'C Carinae' 2-max Seat #1 is the button
Seat 1: rotnem78 ($227.26 in chips) 
Seat 2: Lorpugo ($53.30 in chips) 
rotnem78: posts small blind $0.25
Lorpugo: posts big blind $0.50
*** HOLE CARDS ***
Dealt to Lorpugo [Jh 2c]
rotnem78: calls $0.25
Lorpugo: checks 
*** FLOP *** [Td 4s 9c]
Lorpugo: checks 
rotnem78: bets $0.50
Lorpugo: folds 
Uncalled bet ($0.50) returned to rotnem78
rotnem78 collected $0.94 from pot
rotnem78: doesn't show hand 
*** SUMMARY ***
Total pot $1 | Rake $0.06 
Board [Td 4s 9c]
Seat 1: rotnem78 (button) (small blind) collected ($0.94)
Seat 2: Lorpugo (big blind) folded on the Flop



PokerStars Zoom Hand #236523965064:  Hold'em No Limit ($0.25/$0.50) - 2022/06/02 15:15:30 ET
Table 'C Carinae' 2-max Seat #1 is the button
Seat 1: Lorpugo ($52.80 in chips) 
Seat 2: Lmao7 ($52.98 in chips) 
Lorpugo: posts small blind $0.25
Lmao7: posts big blind $0.50
*** HOLE CARDS ***
Dealt to Lorpugo [Ad Jc]
Lorpugo: raises $0.50 to $1
Lmao7: calls $0.50
*** FLOP *** [4h 6h 5c]
Lmao7: checks 
Lorpugo: bets $0.50
Lmao7: folds 
Uncalled bet ($0.50) returned to Lorpugo
Lorpugo collected $1.90 from pot
Lorpugo: doesn't show hand 
*** SUMMARY ***
Total pot $2 | Rake $0.10 
Board [4h 6h 5c]
Seat 1: Lorpugo (button) (small blind) collected ($1.90)
Seat 2: Lmao7 (big blind) folded on the Flop



PokerStars Zoom Hand #236523973166:  Hold'em No Limit ($0.25/$0.50) - 2022/06/02 15:15:51 ET
Table 'C Carinae' 2-max Seat #1 is the button
Seat 1: candonga ($50 in chips) 
Seat 2: Lorpugo ($53.70 in chips) 
candonga: posts small blind $0.25
Lorpugo: posts big blind $0.50
*** HOLE CARDS ***
Dealt to Lorpugo [4d Th]
candonga: raises $1 to $1.50
Lorpugo: folds 
Uncalled bet ($1) returned to candonga
candonga collected $1 from pot
candonga: doesn't show hand 
*** SUMMARY ***
Total pot $1 | Rake $0 
Seat 1: candonga (button) (small blind) collected ($1)
Seat 2: Lorpugo (big blind) folded before Flop



PokerStars Zoom Hand #236523977717:  Hold'em No Limit ($0.25/$0.50) - 2022/06/02 15:16:03 ET
Table 'C Carinae' 2-max Seat #1 is the button
Seat 1: Lorpugo ($53.20 in chips) 
Seat 2: Limerickey71 ($24.34 in chips) 
Lorpugo: posts small blind $0.25
Limerickey71: posts big blind $0.50
*** HOLE CARDS ***
Dealt to Lorpugo [8h 7d]
Lorpugo: raises $0.60 to $1.10
Limerickey71: calls $0.60
*** FLOP *** [7s 5s Tc]
Limerickey71: checks 
Lorpugo: bets $0.69
Limerickey71: calls $0.69
*** TURN *** [7s 5s Tc] [8c]
Limerickey71: bets $2
Lorpugo: raises $6 to $8
Limerickey71: calls $6
*** RIVER *** [7s 5s Tc 8c] [Qc]
Limerickey71: bets $14.55 and is all-in
Lorpugo: calls $14.55
*** SHOW DOWN ***
Limerickey71: shows [6s 4s] (a straight, Four to Eight)
Lorpugo: shows [8h 7d] (two pair, Eights and Sevens)
Limerickey71 collected $47.93 from pot
*** SUMMARY ***
Total pot $48.68 | Rake $0.75 
Board [7s 5s Tc 8c Qc]
Seat 1: Lorpugo (button) (small blind) showed [8h 7d] and lost with two pair, Eights and Sevens
Seat 2: Limerickey71 (big blind) showed [6s 4s] and won ($47.93) with a straight, Four to Eight



PokerStars Zoom Hand #236523995101:  Hold'em No Limit ($0.25/$0.50) - 2022/06/02 15:16:50 ET
Table 'C Carinae' 2-max Seat #1 is the button
Seat 1: Limerickey71 ($47.93 in chips) 
Seat 2: Lorpugo ($28.86 in chips) 
Limerickey71: posts small blind $0.25
Lorpugo: posts big blind $0.50
*** HOLE CARDS ***
Dealt to Lorpugo [7d 8d]
Limerickey71: raises $0.50 to $1
Lorpugo: calls $0.50
*** FLOP *** [Ad 4s 3s]
Lorpugo: checks 
Limerickey71: checks 
*** TURN *** [Ad 4s 3s] [2h]
Lorpugo: checks 
Limerickey71: bets $1
Lorpugo: folds 
Uncalled bet ($1) returned to Limerickey71
Limerickey71 collected $1.90 from pot
Limerickey71: doesn't show hand 
*** SUMMARY ***
Total pot $2 | Rake $0.10 
Board [Ad 4s 3s 2h]
Seat 1: Limerickey71 (button) (small blind) collected ($1.90)
Seat 2: Lorpugo (big blind) folded on the Turn



PokerStars Zoom Hand #236524006072:  Hold'em No Limit ($0.25/$0.50) - 2022/06/02 15:17:19 ET
Table 'C Carinae' 2-max Seat #1 is the button
Seat 1: Lorpugo ($27.86 in chips) 
Seat 2: idy_hu ($50.50 in chips) 
Lorpugo: posts small blind $0.25
idy_hu: posts big blind $0.50
*** HOLE CARDS ***
Dealt to Lorpugo [Ad As]
Lorpugo: raises $0.50 to $1
idy_hu: calls $0.50
*** FLOP *** [Kd 2d 5c]
idy_hu: checks 
Lorpugo: bets $0.63
idy_hu: calls $0.63
*** TURN *** [Kd 2d 5c] [5s]
idy_hu: checks 
Lorpugo: checks 
*** RIVER *** [Kd 2d 5c 5s] [Js]
idy_hu: checks 
Lorpugo: bets $2.25
idy_hu: calls $2.25
*** SHOW DOWN ***
Lorpugo: shows [Ad As] (two pair, Aces and Fives)
idy_hu: mucks hand 
Lorpugo collected $7.37 from pot
*** SUMMARY ***
Total pot $7.76 | Rake $0.39 
Board [Kd 2d 5c 5s Js]
Seat 1: Lorpugo (button) (small blind) showed [Ad As] and won ($7.37) with two pair, Aces and Fives
Seat 2: idy_hu (big blind) mucked [3h 3s]



PokerStars Zoom Hand #236524021936:  Hold'em No Limit ($0.25/$0.50) - 2022/06/02 15:18:01 ET
Table 'C Carinae' 2-max Seat #1 is the button
Seat 1: DaftBob ($122.45 in chips) 
Seat 2: Lorpugo ($31.35 in chips) 
DaftBob: posts small blind $0.25
Lorpugo: posts big blind $0.50
*** HOLE CARDS ***
Dealt to Lorpugo [9c 3d]
DaftBob: raises $0.50 to $1
Lorpugo: folds 
Uncalled bet ($0.50) returned to DaftBob
DaftBob collected $1 from pot
DaftBob: doesn't show hand 
*** SUMMARY ***
Total pot $1 | Rake $0 
Seat 1: DaftBob (button) (small blind) collected ($1)
Seat 2: Lorpugo (big blind) folded before Flop



PokerStars Zoom Hand #236524025348:  Hold'em No Limit ($0.25/$0.50) - 2022/06/02 15:18:10 ET
Table 'C Carinae' 2-max Seat #1 is the button
Seat 1: tanata932 ($27.58 in chips) 
Seat 2: Lorpugo ($30.85 in chips) 
tanata932: posts small blind $0.25
Lorpugo: posts big blind $0.50
*** HOLE CARDS ***
Dealt to Lorpugo [7h 9d]
tanata932: folds 
Uncalled bet ($0.25) returned to Lorpugo
Lorpugo collected $0.50 from pot
Lorpugo: doesn't show hand 
*** SUMMARY ***
Total pot $0.50 | Rake $0 
Seat 1: tanata932 (button) (small blind) folded before Flop
Seat 2: Lorpugo (big blind) collected ($0.50)



PokerStars Zoom Hand #236524027821:  Hold'em No Limit ($0.25/$0.50) - 2022/06/02 15:18:17 ET
Table 'C Carinae' 2-max Seat #1 is the button
Seat 1: Lorpugo ($31.10 in chips) 
Seat 2: fabsee1 ($103.50 in chips) 
Lorpugo: posts small blind $0.25
fabsee1: posts big blind $0.50
*** HOLE CARDS ***
Dealt to Lorpugo [Kd Ac]
Lorpugo: raises $0.60 to $1.10
fabsee1: calls $0.60
*** FLOP *** [Qc 8d 4d]
fabsee1: checks 
Lorpugo: bets $0.69
fabsee1: folds 
Uncalled bet ($0.69) returned to Lorpugo
Lorpugo collected $2.09 from pot
Lorpugo: doesn't show hand 
*** SUMMARY ***
Total pot $2.20 | Rake $0.11 
Board [Qc 8d 4d]
Seat 1: Lorpugo (button) (small blind) collected ($2.09)
Seat 2: fabsee1 (big blind) folded on the Flop



PokerStars Zoom Hand #236524035413:  Hold'em No Limit ($0.25/$0.50) - 2022/06/02 15:18:37 ET
Table 'C Carinae' 2-max Seat #1 is the button
Seat 1: DaftBob ($126.35 in chips) 
Seat 2: Lorpugo ($32.09 in chips) 
DaftBob: posts small blind $0.25
Lorpugo: posts big blind $0.50
*** HOLE CARDS ***
Dealt to Lorpugo [6s Ah]
DaftBob: raises $0.50 to $1
Lorpugo: calls $0.50
*** FLOP *** [3s 7c Kc]
Lorpugo: checks 
DaftBob: checks 
*** TURN *** [3s 7c Kc] [Td]
Lorpugo: checks 
DaftBob: checks 
*** RIVER *** [3s 7c Kc Td] [3h]
Lorpugo: bets $0.50
DaftBob: raises $124.85 to $125.35 and is all-in
Lorpugo: folds 
Uncalled bet ($124.85) returned to DaftBob
DaftBob collected $2.85 from pot
DaftBob: doesn't show hand 
*** SUMMARY ***
Total pot $3 | Rake $0.15 
Board [3s 7c Kc Td 3h]
Seat 1: DaftBob (button) (small blind) collected ($2.85)
Seat 2: Lorpugo (big blind) folded on the River



PokerStars Zoom Hand #236524051194:  Hold'em No Limit ($0.25/$0.50) - 2022/06/02 15:19:19 ET
Table 'C Carinae' 2-max Seat #1 is the button
Seat 1: Lorpugo ($30.59 in chips) 
Seat 2: DaftBob ($127.70 in chips) 
Lorpugo: posts small blind $0.25
DaftBob: posts big blind $0.50
*** HOLE CARDS ***
Dealt to Lorpugo [Jc 8c]
Lorpugo: raises $0.60 to $1.10
DaftBob: raises $2.40 to $3.50
Lorpugo: calls $2.40
*** FLOP *** [6d 5h 8h]
DaftBob: checks 
Lorpugo: bets $27.09 and is all-in
DaftBob: calls $27.09
*** TURN *** [6d 5h 8h] [6h]
*** RIVER *** [6d 5h 8h 6h] [Kc]
*** SHOW DOWN ***
DaftBob: shows [9h Jh] (a flush, Jack high)
Lorpugo: shows [Jc 8c] (two pair, Eights and Sixes)
DaftBob cashed out the hand for $33.21 | Cash Out Fee $0.34
*** SUMMARY ***
Total pot $61.18 | Rake $0.75 
Board [6d 5h 8h 6h Kc]
Seat 1: Lorpugo (button) (small blind) showed [Jc 8c] and lost with two pair, Eights and Sixes
Seat 2: DaftBob (big blind) showed [9h Jh] and won ($60.43) with a flush, Jack high (pot not awarded as player cashed out)



PokerStars Zoom Hand #236524216951:  Hold'em No Limit ($0.25/$0.50) - 2022/06/02 15:26:23 ET
Table 'C Carinae' 2-max Seat #1 is the button
Seat 1: idy_hu ($78.53 in chips) 
Seat 2: Lorpugo ($28.90 in chips) 
idy_hu: posts small blind $0.25
Lorpugo: posts big blind $0.50
*** HOLE CARDS ***
Dealt to Lorpugo [5s 7h]
idy_hu: folds 
Uncalled bet ($0.25) returned to Lorpugo
Lorpugo collected $0.50 from pot
Lorpugo: doesn't show hand 
*** SUMMARY ***
Total pot $0.50 | Rake $0 
Seat 1: idy_hu (button) (small blind) folded before Flop
Seat 2: Lorpugo (big blind) collected ($0.50)



PokerStars Zoom Hand #236524219552:  Hold'em No Limit ($0.25/$0.50) - 2022/06/02 15:26:30 ET
Table 'C Carinae' 2-max Seat #1 is the button
Seat 1: Lorpugo ($29.15 in chips) 
Seat 2: idy_hu ($78.28 in chips) 
Lorpugo: posts small blind $0.25
idy_hu: posts big blind $0.50
*** HOLE CARDS ***
Dealt to Lorpugo [Ad 7h]
Lorpugo: raises $0.60 to $1.10
idy_hu: calls $0.60
*** FLOP *** [Ts Qs 4h]
idy_hu: checks 
Lorpugo: checks 
*** TURN *** [Ts Qs 4h] [9c]
idy_hu: checks 
Lorpugo: checks 
*** RIVER *** [Ts Qs 4h 9c] [5d]
idy_hu: checks 
Lorpugo: checks 
*** SHOW DOWN ***
idy_hu: shows [7c 9d] (a pair of Nines)
Lorpugo: mucks hand 
idy_hu collected $2.06 from pot
*** SUMMARY ***
Total pot $2.20 | Rake $0.14 
Board [Ts Qs 4h 9c 5d]
Seat 1: Lorpugo (button) (small blind) mucked [Ad 7h]
Seat 2: idy_hu (big blind) showed [7c 9d] and won ($2.06) with a pair of Nines



PokerStars Zoom Hand #236524232718:  Hold'em No Limit ($0.25/$0.50) - 2022/06/02 15:27:04 ET
Table 'C Carinae' 2-max Seat #1 is the button
Seat 1: fabsee1 ($88.74 in chips) 
Seat 2: Lorpugo ($28.05 in chips) 
fabsee1: posts small blind $0.25
Lorpugo: posts big blind $0.50
*** HOLE CARDS ***
Dealt to Lorpugo [5d Qh]
fabsee1: raises $0.50 to $1
Lorpugo: folds 
Uncalled bet ($0.50) returned to fabsee1
fabsee1 collected $1 from pot
fabsee1: doesn't show hand 
*** SUMMARY ***
Total pot $1 | Rake $0 
Seat 1: fabsee1 (button) (small blind) collected ($1)
Seat 2: Lorpugo (big blind) folded before Flop



PokerStars Zoom Hand #236524236728:  Hold'em No Limit ($0.25/$0.50) - 2022/06/02 15:27:15 ET
Table 'C Carinae' 2-max Seat #1 is the button
Seat 1: Lorpugo ($27.55 in chips) 
Seat 2: tanata932 ($16.80 in chips) 
Lorpugo: posts small blind $0.25
tanata932: posts big blind $0.50
*** HOLE CARDS ***
Dealt to Lorpugo [Kc Ks]
Lorpugo: raises $0.50 to $1
tanata932: calls $0.50
*** FLOP *** [8c 8s 4s]
tanata932: checks 
Lorpugo: bets $0.95
tanata932: folds 
Uncalled bet ($0.95) returned to Lorpugo
Lorpugo collected $1.90 from pot
Lorpugo: doesn't show hand 
*** SUMMARY ***
Total pot $2 | Rake $0.10 
Board [8c 8s 4s]
Seat 1: Lorpugo (button) (small blind) collected ($1.90)
Seat 2: tanata932 (big blind) folded on the Flop



PokerStars Zoom Hand #236524243243:  Hold'em No Limit ($0.25/$0.50) - 2022/06/02 15:27:32 ET
Table 'C Carinae' 2-max Seat #1 is the button
Seat 1: puffpatrol52 ($23.97 in chips) 
Seat 2: Lorpugo ($28.45 in chips) 
puffpatrol52: posts small blind $0.25
Lorpugo: posts big blind $0.50
*** HOLE CARDS ***
Dealt to Lorpugo [Js 2s]
puffpatrol52: folds 
Uncalled bet ($0.25) returned to Lorpugo
Lorpugo collected $0.50 from pot
Lorpugo: doesn't show hand 
*** SUMMARY ***
Total pot $0.50 | Rake $0 
Seat 1: puffpatrol52 (button) (small blind) folded before Flop
Seat 2: Lorpugo (big blind) collected ($0.50)



PokerStars Zoom Hand #236524245954:  Hold'em No Limit ($0.25/$0.50) - 2022/06/02 15:27:39 ET
Table 'C Carinae' 2-max Seat #1 is the button
Seat 1: puffpatrol52 ($23.72 in chips) 
Seat 2: Lorpugo ($28.70 in chips) 
puffpatrol52: posts small blind $0.25
Lorpugo: posts big blind $0.50
*** HOLE CARDS ***
Dealt to Lorpugo [Ah Qs]
puffpatrol52: folds 
Uncalled bet ($0.25) returned to Lorpugo
Lorpugo collected $0.50 from pot
Lorpugo: doesn't show hand 
*** SUMMARY ***
Total pot $0.50 | Rake $0 
Seat 1: puffpatrol52 (button) (small blind) folded before Flop
Seat 2: Lorpugo (big blind) collected ($0.50)



PokerStars Zoom Hand #236524248156:  Hold'em No Limit ($0.25/$0.50) - 2022/06/02 15:27:45 ET
Table 'C Carinae' 2-max Seat #1 is the button
Seat 1: Lorpugo ($28.95 in chips) 
Seat 2: puffpatrol52 ($23.47 in chips) 
Lorpugo: posts small blind $0.25
puffpatrol52: posts big blind $0.50
*** HOLE CARDS ***
Dealt to Lorpugo [7h Tc]
Lorpugo: raises $0.60 to $1.10
puffpatrol52: folds 
Uncalled bet ($0.60) returned to Lorpugo
Lorpugo collected $1 from pot
Lorpugo: doesn't show hand 
*** SUMMARY ***
Total pot $1 | Rake $0 
Seat 1: Lorpugo (button) (small blind) collected ($1)
Seat 2: puffpatrol52 (big blind) folded before Flop



PokerStars Zoom Hand #236524251949:  Hold'em No Limit ($0.25/$0.50) - 2022/06/02 15:27:54 ET
Table 'C Carinae' 2-max Seat #1 is the button
Seat 1: Lorpugo ($29.45 in chips) 
Seat 2: fabsee1 ($91.93 in chips) 
Lorpugo: posts small blind $0.25
fabsee1: posts big blind $0.50
*** HOLE CARDS ***
Dealt to Lorpugo [Ts 2d]
Lorpugo: folds 
Uncalled bet ($0.25) returned to fabsee1
fabsee1 collected $0.50 from pot
fabsee1: doesn't show hand 
*** SUMMARY ***
Total pot $0.50 | Rake $0 
Seat 1: Lorpugo (button) (small blind) folded before Flop
Seat 2: fabsee1 (big blind) collected ($0.50)



PokerStars Zoom Hand #236524254344:  Hold'em No Limit ($0.25/$0.50) - 2022/06/02 15:28:01 ET
Table 'C Carinae' 2-max Seat #1 is the button
Seat 1: friediii11 ($51.79 in chips) 
Seat 2: Lorpugo ($29.20 in chips) 
friediii11: posts small blind $0.25
Lorpugo: posts big blind $0.50
*** HOLE CARDS ***
Dealt to Lorpugo [Qd 2s]
friediii11: raises $0.75 to $1.25
Lorpugo: folds 
Uncalled bet ($0.75) returned to friediii11
friediii11 collected $1 from pot
friediii11: doesn't show hand 
*** SUMMARY ***
Total pot $1 | Rake $0 
Seat 1: friediii11 (button) (small blind) collected ($1)
Seat 2: Lorpugo (big blind) folded before Flop



PokerStars Zoom Hand #236524258904:  Hold'em No Limit ($0.25/$0.50) - 2022/06/02 15:28:13 ET
Table 'C Carinae' 2-max Seat #1 is the button
Seat 1: Lorpugo ($28.70 in chips) 
Seat 2: M4GPI3 ($50 in chips) 
Lorpugo: posts small blind $0.25
M4GPI3: posts big blind $0.50
*** HOLE CARDS ***
Dealt to Lorpugo [Ts Ks]
Lorpugo: raises $0.60 to $1.10
M4GPI3: calls $0.60
*** FLOP *** [7d 3d 6h]
M4GPI3: checks 
Lorpugo: checks 
*** TURN *** [7d 3d 6h] [9c]
M4GPI3: checks 
Lorpugo: bets $0.69
M4GPI3: folds 
Uncalled bet ($0.69) returned to Lorpugo
Lorpugo collected $2.09 from pot
Lorpugo: doesn't show hand 
*** SUMMARY ***
Total pot $2.20 | Rake $0.11 
Board [7d 3d 6h 9c]
Seat 1: Lorpugo (button) (small blind) collected ($2.09)
Seat 2: M4GPI3 (big blind) folded on the Turn



PokerStars Zoom Hand #236524270642:  Hold'em No Limit ($0.25/$0.50) - 2022/06/02 15:28:44 ET
Table 'C Carinae' 2-max Seat #1 is the button
Seat 1: OverCologne ($50 in chips) 
Seat 2: Lorpugo ($29.69 in chips) 
OverCologne: posts small blind $0.25
Lorpugo: posts big blind $0.50
*** HOLE CARDS ***
Dealt to Lorpugo [Js 2s]
OverCologne: raises $0.75 to $1.25
Lorpugo: calls $0.75
*** FLOP *** [4c 3d 4h]
Lorpugo: checks 
OverCologne: bets $0.79
Lorpugo: folds 
Uncalled bet ($0.79) returned to OverCologne
OverCologne collected $2.38 from pot
OverCologne: doesn't show hand 
*** SUMMARY ***
Total pot $2.50 | Rake $0.12 
Board [4c 3d 4h]
Seat 1: OverCologne (button) (small blind) collected ($2.38)
Seat 2: Lorpugo (big blind) folded on the Flop



PokerStars Zoom Hand #236524280312:  Hold'em No Limit ($0.25/$0.50) - 2022/06/02 15:29:09 ET
Table 'C Carinae' 2-max Seat #1 is the button
Seat 1: Lorpugo ($28.44 in chips) 
Seat 2: OverCologne ($51.13 in chips) 
Lorpugo: posts small blind $0.25
OverCologne: posts big blind $0.50
*** HOLE CARDS ***
Dealt to Lorpugo [Ah 6d]
Lorpugo: raises $0.60 to $1.10
OverCologne: folds 
Uncalled bet ($0.60) returned to Lorpugo
Lorpugo collected $1 from pot
Lorpugo: doesn't show hand 
*** SUMMARY ***
Total pot $1 | Rake $0 
Seat 1: Lorpugo (button) (small blind) collected ($1)
Seat 2: OverCologne (big blind) folded before Flop



PokerStars Zoom Hand #236524283813:  Hold'em No Limit ($0.25/$0.50) - 2022/06/02 15:29:18 ET
Table 'C Carinae' 2-max Seat #1 is the button
Seat 1: friediii11 ($50 in chips) 
Seat 2: Lorpugo ($28.94 in chips) 
friediii11: posts small blind $0.25
Lorpugo: posts big blind $0.50
*** HOLE CARDS ***
Dealt to Lorpugo [Jc 7h]
friediii11: folds 
Uncalled bet ($0.25) returned to Lorpugo
Lorpugo collected $0.50 from pot
Lorpugo: doesn't show hand 
*** SUMMARY ***
Total pot $0.50 | Rake $0 
Seat 1: friediii11 (button) (small blind) folded before Flop
Seat 2: Lorpugo (big blind) collected ($0.50)



PokerStars Zoom Hand #236524286097:  Hold'em No Limit ($0.25/$0.50) - 2022/06/02 15:29:24 ET
Table 'C Carinae' 2-max Seat #1 is the button
Seat 1: Lorpugo ($29.19 in chips) 
Seat 2: friediii11 ($50 in chips) 
Lorpugo: posts small blind $0.25
friediii11: posts big blind $0.50
*** HOLE CARDS ***
Dealt to Lorpugo [7h Js]
Lorpugo: raises $0.60 to $1.10
friediii11: folds 
Uncalled bet ($0.60) returned to Lorpugo
Lorpugo collected $1 from pot
Lorpugo: doesn't show hand 
*** SUMMARY ***
Total pot $1 | Rake $0 
Seat 1: Lorpugo (button) (small blind) collected ($1)
Seat 2: friediii11 (big blind) folded before Flop



PokerStars Zoom Hand #236524290610:  Hold'em No Limit ($0.25/$0.50) - 2022/06/02 15:29:36 ET
Table 'C Carinae' 2-max Seat #1 is the button
Seat 1: OverCologne ($55.10 in chips) 
Seat 2: Lorpugo ($29.69 in chips) 
OverCologne: posts small blind $0.25
Lorpugo: posts big blind $0.50
*** HOLE CARDS ***
Dealt to Lorpugo [Qs 9c]
OverCologne: raises $0.75 to $1.25
Lorpugo: calls $0.75
*** FLOP *** [Ah 3h 5c]
Lorpugo: checks 
OverCologne: checks 
*** TURN *** [Ah 3h 5c] [3d]
Lorpugo: checks 
OverCologne: checks 
*** RIVER *** [Ah 3h 5c 3d] [6c]
Lorpugo: bets $0.50
OverCologne: folds 
Uncalled bet ($0.50) returned to Lorpugo
Lorpugo collected $2.38 from pot
Lorpugo: doesn't show hand 
*** SUMMARY ***
Total pot $2.50 | Rake $0.12 
Board [Ah 3h 5c 3d 6c]
Seat 1: OverCologne (button) (small blind) folded on the River
Seat 2: Lorpugo (big blind) collected ($2.38)



PokerStars Zoom Hand #236524305583:  Hold'em No Limit ($0.25/$0.50) - 2022/06/02 15:30:15 ET
Table 'C Carinae' 2-max Seat #1 is the button
Seat 1: Lorpugo ($30.82 in chips) 
Seat 2: candonga ($82.23 in chips) 
Lorpugo: posts small blind $0.25
candonga: posts big blind $0.50
*** HOLE CARDS ***
Dealt to Lorpugo [8s Td]
Lorpugo: raises $0.50 to $1
candonga: calls $0.50
*** FLOP *** [Qd 7c Th]
candonga: checks 
Lorpugo: bets $0.85
candonga: folds 
Uncalled bet ($0.85) returned to Lorpugo
Lorpugo collected $1.90 from pot
Lorpugo: doesn't show hand 
*** SUMMARY ***
Total pot $2 | Rake $0.10 
Board [Qd 7c Th]
Seat 1: Lorpugo (button) (small blind) collected ($1.90)
Seat 2: candonga (big blind) folded on the Flop



PokerStars Zoom Hand #236524322755:  Hold'em No Limit ($0.25/$0.50) - 2022/06/02 15:31:01 ET
Table 'C Carinae' 2-max Seat #1 is the button
Seat 1: candonga ($81.23 in chips) 
Seat 2: Lorpugo ($31.72 in chips) 
candonga: posts small blind $0.25
Lorpugo: posts big blind $0.50
*** HOLE CARDS ***
Dealt to Lorpugo [9d 4d]
candonga: raises $1 to $1.50
Lorpugo: folds 
Uncalled bet ($1) returned to candonga
candonga collected $1 from pot
candonga: doesn't show hand 
*** SUMMARY ***
Total pot $1 | Rake $0 
Seat 1: candonga (button) (small blind) collected ($1)
Seat 2: Lorpugo (big blind) folded before Flop



PokerStars Zoom Hand #236524327340:  Hold'em No Limit ($0.25/$0.50) - 2022/06/02 15:31:12 ET
Table 'C Carinae' 2-max Seat #1 is the button
Seat 1: Lorpugo ($31.22 in chips) 
Seat 2: MrSuperior ($66.02 in chips) 
Lorpugo: posts small blind $0.25
MrSuperior: posts big blind $0.50
*** HOLE CARDS ***
Dealt to Lorpugo [9d 8s]
Lorpugo: raises $0.60 to $1.10
MrSuperior: calls $0.60
*** FLOP *** [5h Jd Qc]
MrSuperior: checks 
Lorpugo: checks 
*** TURN *** [5h Jd Qc] [Td]
MrSuperior: checks 
Lorpugo: bets $1
MrSuperior: folds 
Uncalled bet ($1) returned to Lorpugo
Lorpugo collected $2.09 from pot
Lorpugo: doesn't show hand 
*** SUMMARY ***
Total pot $2.20 | Rake $0.11 
Board [5h Jd Qc Td]
Seat 1: Lorpugo (button) (small blind) collected ($2.09)
Seat 2: MrSuperior (big blind) folded on the Turn



PokerStars Zoom Hand #236524339822:  Hold'em No Limit ($0.25/$0.50) - 2022/06/02 15:31:45 ET
Table 'C Carinae' 2-max Seat #1 is the button
Seat 1: friediii11 ($50 in chips) 
Seat 2: Lorpugo ($32.21 in chips) 
friediii11: posts small blind $0.25
Lorpugo: posts big blind $0.50
*** HOLE CARDS ***
Dealt to Lorpugo [6d 9c]
friediii11: raises $0.75 to $1.25
Lorpugo: folds 
Uncalled bet ($0.75) returned to friediii11
friediii11 collected $1 from pot
friediii11: doesn't show hand 
*** SUMMARY ***
Total pot $1 | Rake $0 
Seat 1: friediii11 (button) (small blind) collected ($1)
Seat 2: Lorpugo (big blind) folded before Flop



PokerStars Zoom Hand #236524342771:  Hold'em No Limit ($0.25/$0.50) - 2022/06/02 15:31:52 ET
Table 'C Carinae' 2-max Seat #1 is the button
Seat 1: Lorpugo ($31.71 in chips) 
Seat 2: friediii11 ($50.75 in chips) 
Lorpugo: posts small blind $0.25
friediii11: posts big blind $0.50
*** HOLE CARDS ***
Dealt to Lorpugo [Kd 6s]
Lorpugo: raises $0.50 to $1
friediii11: raises $4 to $5
Lorpugo: folds 
Uncalled bet ($4) returned to friediii11
friediii11 collected $2 from pot
friediii11: doesn't show hand 
*** SUMMARY ***
Total pot $2 | Rake $0 
Seat 1: Lorpugo (button) (small blind) folded before Flop
Seat 2: friediii11 (big blind) collected ($2)



PokerStars Zoom Hand #236524352507:  Hold'em No Limit ($0.25/$0.50) - 2022/06/02 15:32:11 ET
Table 'C Carinae' 2-max Seat #1 is the button
Seat 1: friediii11 ($51.75 in chips) 
Seat 2: Lorpugo ($30.71 in chips) 
friediii11: posts small blind $0.25
Lorpugo: posts big blind $0.50
*** HOLE CARDS ***
Dealt to Lorpugo [Qs 8c]
friediii11: raises $0.75 to $1.25
Lorpugo: calls $0.75
*** FLOP *** [6d 9h Jc]
Lorpugo: checks 
friediii11: bets $1.25
Lorpugo: calls $1.25
*** TURN *** [6d 9h Jc] [3s]
Lorpugo: checks 
friediii11: checks 
*** RIVER *** [6d 9h Jc 3s] [Kc]
Lorpugo: bets $3.50
friediii11: folds 
Uncalled bet ($3.50) returned to Lorpugo
Lorpugo collected $4.75 from pot
Lorpugo: doesn't show hand 
*** SUMMARY ***
Total pot $5 | Rake $0.25 
Board [6d 9h Jc 3s Kc]
Seat 1: friediii11 (button) (small blind) folded on the River
Seat 2: Lorpugo (big blind) collected ($4.75)



PokerStars Zoom Hand #236524369346:  Hold'em No Limit ($0.25/$0.50) - 2022/06/02 15:32:55 ET
Table 'C Carinae' 2-max Seat #1 is the button
Seat 1: Lorpugo ($32.96 in chips) 
Seat 2: Lmao7 ($54.69 in chips) 
Lorpugo: posts small blind $0.25
Lmao7: posts big blind $0.50
*** HOLE CARDS ***
Dealt to Lorpugo [Qs 8s]
Lorpugo: raises $0.60 to $1.10
Lmao7: calls $0.60
*** FLOP *** [7s 2c 2d]
Lmao7: checks 
Lorpugo: bets $0.69
Lmao7: raises $1.15 to $1.84
Lorpugo: calls $1.15
*** TURN *** [7s 2c 2d] [2h]
Lmao7: checks 
Lorpugo: checks 
*** RIVER *** [7s 2c 2d 2h] [Qh]
Lmao7: bets $1.40
Lorpugo: raises $5.10 to $6.50
Lmao7: folds 
Uncalled bet ($5.10) returned to Lorpugo
Lorpugo collected $8.25 from pot
Lorpugo: doesn't show hand 
*** SUMMARY ***
Total pot $8.68 | Rake $0.43 
Board [7s 2c 2d 2h Qh]
Seat 1: Lorpugo (button) (small blind) collected ($8.25)
Seat 2: Lmao7 (big blind) folded on the River



PokerStars Zoom Hand #236524402388:  Hold'em No Limit ($0.25/$0.50) - 2022/06/02 15:34:20 ET
Table 'C Carinae' 2-max Seat #1 is the button
Seat 1: MrSuperior ($125.82 in chips) 
Seat 2: Lorpugo ($36.87 in chips) 
MrSuperior: posts small blind $0.25
Lorpugo: posts big blind $0.50
*** HOLE CARDS ***
Dealt to Lorpugo [Js 5h]
MrSuperior: raises $1 to $1.50
Lorpugo: folds 
Uncalled bet ($1) returned to MrSuperior
MrSuperior collected $1 from pot
MrSuperior: doesn't show hand 
*** SUMMARY ***
Total pot $1 | Rake $0 
Seat 1: MrSuperior (button) (small blind) collected ($1)
Seat 2: Lorpugo (big blind) folded before Flop



PokerStars Zoom Hand #236524406971:  Hold'em No Limit ($0.25/$0.50) - 2022/06/02 15:34:32 ET
Table 'C Carinae' 2-max Seat #1 is the button
Seat 1: tanata932 ($33.88 in chips) 
Seat 2: Lorpugo ($36.37 in chips) 
tanata932: posts small blind $0.25
Lorpugo: posts big blind $0.50
*** HOLE CARDS ***
Dealt to Lorpugo [5h 4h]
tanata932: raises $1 to $1.50
Lorpugo: raises $3 to $4.50
tanata932: calls $3
*** FLOP *** [6d Qc Js]
Lorpugo: checks 
tanata932: bets $6.50
Lorpugo: folds 
Uncalled bet ($6.50) returned to tanata932
tanata932 collected $8.55 from pot
tanata932: doesn't show hand 
*** SUMMARY ***
Total pot $9 | Rake $0.45 
Board [6d Qc Js]
Seat 1: tanata932 (button) (small blind) collected ($8.55)
Seat 2: Lorpugo (big blind) folded on the Flop



PokerStars Zoom Hand #236524419945:  Hold'em No Limit ($0.25/$0.50) - 2022/06/02 15:35:06 ET
Table 'C Carinae' 2-max Seat #1 is the button
Seat 1: candonga ($52.54 in chips) 
Seat 2: Lorpugo ($31.87 in chips) 
candonga: posts small blind $0.25
Lorpugo: posts big blind $0.50
*** HOLE CARDS ***
Dealt to Lorpugo [2h 6s]
candonga: raises $1 to $1.50
Lorpugo: folds 
Uncalled bet ($1) returned to candonga
candonga collected $1 from pot
candonga: doesn't show hand 
*** SUMMARY ***
Total pot $1 | Rake $0 
Seat 1: candonga (button) (small blind) collected ($1)
Seat 2: Lorpugo (big blind) folded before Flop



PokerStars Zoom Hand #236524424482:  Hold'em No Limit ($0.25/$0.50) - 2022/06/02 15:35:17 ET
Table 'C Carinae' 2-max Seat #1 is the button
Seat 1: Lorpugo ($31.37 in chips) 
Seat 2: idy_hu ($73.69 in chips) 
Lorpugo: posts small blind $0.25
idy_hu: posts big blind $0.50
*** HOLE CARDS ***
Dealt to Lorpugo [Ah Jd]
Lorpugo: raises $0.60 to $1.10
idy_hu: calls $0.60
*** FLOP *** [Ts 6d Qc]
idy_hu: checks 
Lorpugo: bets $0.69
idy_hu: calls $0.69
*** TURN *** [Ts 6d Qc] [4h]
idy_hu: checks 
Lorpugo: checks 
*** RIVER *** [Ts 6d Qc 4h] [Ac]
idy_hu: checks 
Lorpugo: bets $2.50
idy_hu: folds 
Uncalled bet ($2.50) returned to Lorpugo
Lorpugo collected $3.40 from pot
Lorpugo: doesn't show hand 
*** SUMMARY ***
Total pot $3.58 | Rake $0.18 
Board [Ts 6d Qc 4h Ac]
Seat 1: Lorpugo (button) (small blind) collected ($3.40)
Seat 2: idy_hu (big blind) folded on the River



PokerStars Zoom Hand #236524440608:  Hold'em No Limit ($0.25/$0.50) - 2022/06/02 15:35:59 ET
Table 'C Carinae' 2-max Seat #1 is the button
Seat 1: Lorpugo ($32.98 in chips) 
Seat 2: puffpatrol52 ($17.56 in chips) 
Lorpugo: posts small blind $0.25
puffpatrol52: posts big blind $0.50
*** HOLE CARDS ***
Dealt to Lorpugo [8d 4s]
Lorpugo: folds 
Uncalled bet ($0.25) returned to puffpatrol52
puffpatrol52 collected $0.50 from pot
puffpatrol52: doesn't show hand 
*** SUMMARY ***
Total pot $0.50 | Rake $0 
Seat 1: Lorpugo (button) (small blind) folded before Flop
Seat 2: puffpatrol52 (big blind) collected ($0.50)



PokerStars Zoom Hand #236524443779:  Hold'em No Limit ($0.25/$0.50) - 2022/06/02 15:36:07 ET
Table 'C Carinae' 2-max Seat #1 is the button
Seat 1: Lorpugo ($32.73 in chips) 
Seat 2: M4GPI3 ($58.31 in chips) 
Lorpugo: posts small blind $0.25
M4GPI3: posts big blind $0.50
*** HOLE CARDS ***
Dealt to Lorpugo [Kd Ac]
Lorpugo: raises $0.60 to $1.10
M4GPI3: calls $0.60
*** FLOP *** [Qh 3d 7d]
M4GPI3: checks 
Lorpugo: bets $0.69
M4GPI3: calls $0.69
*** TURN *** [Qh 3d 7d] [5h]
M4GPI3: checks 
Lorpugo: bets $1.70
M4GPI3: calls $1.70
*** RIVER *** [Qh 3d 7d 5h] [2c]
M4GPI3: checks 
Lorpugo: checks 
*** SHOW DOWN ***
M4GPI3: shows [9d 6d] (high card Queen)
Lorpugo: shows [Kd Ac] (high card Ace)
Lorpugo collected $6.63 from pot
*** SUMMARY ***
Total pot $6.98 | Rake $0.35 
Board [Qh 3d 7d 5h 2c]
Seat 1: Lorpugo (button) (small blind) showed [Kd Ac] and won ($6.63) with high card Ace
Seat 2: M4GPI3 (big blind) showed [9d 6d] and lost with high card Queen



PokerStars Zoom Hand #236524460714:  Hold'em No Limit ($0.25/$0.50) - 2022/06/02 15:36:50 ET
Table 'C Carinae' 2-max Seat #1 is the button
Seat 1: M4GPI3 ($54.82 in chips) 
Seat 2: Lorpugo ($35.87 in chips) 
M4GPI3: posts small blind $0.25
Lorpugo: posts big blind $0.50
*** HOLE CARDS ***
Dealt to Lorpugo [7c 9d]
M4GPI3: raises $0.75 to $1.25
Lorpugo: calls $0.75
*** FLOP *** [7h 5s 8c]
Lorpugo: checks 
M4GPI3: checks 
*** TURN *** [7h 5s 8c] [8d]
Lorpugo: bets $1.40
M4GPI3: calls $1.40
*** RIVER *** [7h 5s 8c 8d] [Js]
Lorpugo: checks 
M4GPI3: checks 
*** SHOW DOWN ***
Lorpugo: shows [7c 9d] (two pair, Eights and Sevens)
M4GPI3: shows [7d 3d] (two pair, Eights and Sevens)
Lorpugo collected $2.52 from pot
M4GPI3 collected $2.52 from pot
*** SUMMARY ***
Total pot $5.30 | Rake $0.26 
Board [7h 5s 8c 8d Js]
Seat 1: M4GPI3 (button) (small blind) showed [7d 3d] and won ($2.52) with two pair, Eights and Sevens
Seat 2: Lorpugo (big blind) showed [7c 9d] and won ($2.52) with two pair, Eights and Sevens



PokerStars Zoom Hand #236524479033:  Hold'em No Limit ($0.25/$0.50) - 2022/06/02 15:37:37 ET
Table 'C Carinae' 2-max Seat #1 is the button
Seat 1: Lorpugo ($35.74 in chips) 
Seat 2: domlenny ($106.34 in chips) 
Lorpugo: posts small blind $0.25
domlenny: posts big blind $0.50
*** HOLE CARDS ***
Dealt to Lorpugo [Jh 4s]
Lorpugo: folds 
Uncalled bet ($0.25) returned to domlenny
domlenny collected $0.50 from pot
domlenny: doesn't show hand 
*** SUMMARY ***
Total pot $0.50 | Rake $0 
Seat 1: Lorpugo (button) (small blind) folded before Flop
Seat 2: domlenny (big blind) collected ($0.50)



PokerStars Zoom Hand #236524482087:  Hold'em No Limit ($0.25/$0.50) - 2022/06/02 15:37:45 ET
Table 'C Carinae' 2-max Seat #1 is the button
Seat 1: Artagas1 ($50 in chips) 
Seat 2: Lorpugo ($35.49 in chips) 
Artagas1: posts small blind $0.25
Lorpugo: posts big blind $0.50
*** HOLE CARDS ***
Dealt to Lorpugo [Tc 4h]
Artagas1: raises $0.75 to $1.25
Lorpugo: folds 
Uncalled bet ($0.75) returned to Artagas1
Artagas1 collected $1 from pot
Artagas1: doesn't show hand 
*** SUMMARY ***
Total pot $1 | Rake $0 
Seat 1: Artagas1 (button) (small blind) collected ($1)
Seat 2: Lorpugo (big blind) folded before Flop



PokerStars Zoom Hand #236524488119:  Hold'em No Limit ($0.25/$0.50) - 2022/06/02 15:38:00 ET
Table 'C Carinae' 2-max Seat #1 is the button
Seat 1: Lorpugo ($34.99 in chips) 
Seat 2: M4GPI3 ($58.35 in chips) 
Lorpugo: posts small blind $0.25
M4GPI3: posts big blind $0.50
*** HOLE CARDS ***
Dealt to Lorpugo [6d 4c]
Lorpugo: raises $0.50 to $1
M4GPI3: calls $0.50
*** FLOP *** [9s 2d Qh]
M4GPI3: checks 
Lorpugo: checks 
*** TURN *** [9s 2d Qh] [8h]
M4GPI3: checks 
Lorpugo: checks 
*** RIVER *** [9s 2d Qh 8h] [5d]
M4GPI3: checks 
Lorpugo: checks 
*** SHOW DOWN ***
M4GPI3: shows [Kd 5c] (a pair of Fives)
Lorpugo: mucks hand 
M4GPI3 collected $1.90 from pot
*** SUMMARY ***
Total pot $2 | Rake $0.10 
Board [9s 2d Qh 8h 5d]
Seat 1: Lorpugo (button) (small blind) mucked [6d 4c]
Seat 2: M4GPI3 (big blind) showed [Kd 5c] and won ($1.90) with a pair of Fives



PokerStars Zoom Hand #236524506668:  Hold'em No Limit ($0.25/$0.50) - 2022/06/02 15:38:47 ET
Table 'C Carinae' 2-max Seat #1 is the button
Seat 1: MrSuperior ($140.65 in chips) 
Seat 2: Lorpugo ($33.99 in chips) 
MrSuperior: posts small blind $0.25
Lorpugo: posts big blind $0.50
*** HOLE CARDS ***
Dealt to Lorpugo [Jh Kh]
MrSuperior: folds 
Uncalled bet ($0.25) returned to Lorpugo
Lorpugo collected $0.50 from pot
Lorpugo: doesn't show hand 
*** SUMMARY ***
Total pot $0.50 | Rake $0 
Seat 1: MrSuperior (button) (small blind) folded before Flop
Seat 2: Lorpugo (big blind) collected ($0.50)



PokerStars Zoom Hand #236524509432:  Hold'em No Limit ($0.25/$0.50) - 2022/06/02 15:38:55 ET
Table 'C Carinae' 2-max Seat #1 is the button
Seat 1: friediii11 ($50 in chips) 
Seat 2: Lorpugo ($34.24 in chips) 
friediii11: posts small blind $0.25
Lorpugo: posts big blind $0.50
*** HOLE CARDS ***
Dealt to Lorpugo [5s Jc]
friediii11: raises $0.75 to $1.25
Lorpugo: folds 
Uncalled bet ($0.75) returned to friediii11
friediii11 collected $1 from pot
friediii11: doesn't show hand 
*** SUMMARY ***
Total pot $1 | Rake $0 
Seat 1: friediii11 (button) (small blind) collected ($1)
Seat 2: Lorpugo (big blind) folded before Flop



PokerStars Zoom Hand #236524513998:  Hold'em No Limit ($0.25/$0.50) - 2022/06/02 15:39:06 ET
Table 'C Carinae' 2-max Seat #1 is the button
Seat 1: Lorpugo ($33.74 in chips) 
Seat 2: M4GPI3 ($50 in chips) 
Lorpugo: posts small blind $0.25
M4GPI3: posts big blind $0.50
*** HOLE CARDS ***
Dealt to Lorpugo [Qc Th]
Lorpugo: raises $0.60 to $1.10
M4GPI3: folds 
Uncalled bet ($0.60) returned to Lorpugo
Lorpugo collected $1 from pot
Lorpugo: doesn't show hand 
*** SUMMARY ***
Total pot $1 | Rake $0 
Seat 1: Lorpugo (button) (small blind) collected ($1)
Seat 2: M4GPI3 (big blind) folded before Flop



PokerStars Zoom Hand #236524518756:  Hold'em No Limit ($0.25/$0.50) - 2022/06/02 15:39:18 ET
Table 'C Carinae' 2-max Seat #1 is the button
Seat 1: Lorpugo ($34.24 in chips) 
Seat 2: idy_hu ($50.24 in chips) 
Lorpugo: posts small blind $0.25
idy_hu: posts big blind $0.50
*** HOLE CARDS ***
Dealt to Lorpugo [Ac 5d]
Lorpugo: raises $0.60 to $1.10
idy_hu: folds 
Uncalled bet ($0.60) returned to Lorpugo
Lorpugo collected $1 from pot
Lorpugo: doesn't show hand 
*** SUMMARY ***
Total pot $1 | Rake $0 
Seat 1: Lorpugo (button) (small blind) collected ($1)
Seat 2: idy_hu (big blind) folded before Flop



PokerStars Zoom Hand #236524524691:  Hold'em No Limit ($0.25/$0.50) - 2022/06/02 15:39:34 ET
Table 'C Carinae' 2-max Seat #1 is the button
Seat 1: Lorpugo ($34.74 in chips) 
Seat 2: OverCologne ($50 in chips) 
Lorpugo: posts small blind $0.25
OverCologne: posts big blind $0.50
*** HOLE CARDS ***
Dealt to Lorpugo [5d 9h]
Lorpugo: folds 
Uncalled bet ($0.25) returned to OverCologne
OverCologne collected $0.50 from pot
OverCologne: doesn't show hand 
*** SUMMARY ***
Total pot $0.50 | Rake $0 
Seat 1: Lorpugo (button) (small blind) folded before Flop
Seat 2: OverCologne (big blind) collected ($0.50)



PokerStars Zoom Hand #236524528196:  Hold'em No Limit ($0.25/$0.50) - 2022/06/02 15:39:43 ET
Table 'C Carinae' 2-max Seat #1 is the button
Seat 1: Artagas1 ($52.33 in chips) 
Seat 2: Lorpugo ($34.49 in chips) 
Artagas1: posts small blind $0.25
Lorpugo: posts big blind $0.50
*** HOLE CARDS ***
Dealt to Lorpugo [5c 7h]
Artagas1: raises $0.75 to $1.25
Lorpugo: folds 
Uncalled bet ($0.75) returned to Artagas1
Artagas1 collected $1 from pot
Artagas1: doesn't show hand 
*** SUMMARY ***
Total pot $1 | Rake $0 
Seat 1: Artagas1 (button) (small blind) collected ($1)
Seat 2: Lorpugo (big blind) folded before Flop



PokerStars Zoom Hand #236524532798:  Hold'em No Limit ($0.25/$0.50) - 2022/06/02 15:39:54 ET
Table 'C Carinae' 2-max Seat #1 is the button
Seat 1: Lorpugo ($33.99 in chips) 
Seat 2: OverCologne ($50 in chips) 
Lorpugo: posts small blind $0.25
OverCologne: posts big blind $0.50
*** HOLE CARDS ***
Dealt to Lorpugo [5d 9c]
Lorpugo: folds 
Uncalled bet ($0.25) returned to OverCologne
OverCologne collected $0.50 from pot
OverCologne: doesn't show hand 
*** SUMMARY ***
Total pot $0.50 | Rake $0 
Seat 1: Lorpugo (button) (small blind) folded before Flop
Seat 2: OverCologne (big blind) collected ($0.50)



PokerStars Zoom Hand #236524536135:  Hold'em No Limit ($0.25/$0.50) - 2022/06/02 15:40:03 ET
Table 'C Carinae' 2-max Seat #1 is the button
Seat 1: Limerickey71 ($42.04 in chips) 
Seat 2: Lorpugo ($33.74 in chips) 
Limerickey71: posts small blind $0.25
Lorpugo: posts big blind $0.50
*** HOLE CARDS ***
Dealt to Lorpugo [Qd Tc]
Limerickey71: raises $0.50 to $1
Lorpugo: calls $0.50
*** FLOP *** [3d 2h 2c]
Lorpugo: checks 
Limerickey71: checks 
*** TURN *** [3d 2h 2c] [3h]
Lorpugo: bets $0.50
Limerickey71: folds 
Uncalled bet ($0.50) returned to Lorpugo
Lorpugo collected $1.90 from pot
Lorpugo: doesn't show hand 
*** SUMMARY ***
Total pot $2 | Rake $0.10 
Board [3d 2h 2c 3h]
Seat 1: Limerickey71 (button) (small blind) folded on the Turn
Seat 2: Lorpugo (big blind) collected ($1.90)



PokerStars Zoom Hand #236524549929:  Hold'em No Limit ($0.25/$0.50) - 2022/06/02 15:40:32 ET
Table 'C Carinae' 2-max Seat #1 is the button
Seat 1: Lorpugo ($34.64 in chips) 
Seat 2: Lmao7 ($57.88 in chips) 
Lorpugo: posts small blind $0.25
Lmao7: posts big blind $0.50
*** HOLE CARDS ***
Dealt to Lorpugo [As 3h]
Lorpugo: raises $0.60 to $1.10
Lmao7: calls $0.60
*** FLOP *** [Qd 5d Qs]
Lmao7: checks 
Lorpugo: bets $0.69
Lmao7: calls $0.69
*** TURN *** [Qd 5d Qs] [2c]
Lmao7: checks 
Lorpugo: checks 
*** RIVER *** [Qd 5d Qs 2c] [2s]
Lmao7: bets $0.50
Lorpugo: calls $0.50
*** SHOW DOWN ***
Lmao7: shows [Ad 8s] (two pair, Queens and Deuces)
Lorpugo: shows [As 3h] (two pair, Queens and Deuces)
Lmao7 collected $2.18 from pot
Lorpugo collected $2.17 from pot
*** SUMMARY ***
Total pot $4.58 | Rake $0.23 
Board [Qd 5d Qs 2c 2s]
Seat 1: Lorpugo (button) (small blind) showed [As 3h] and won ($2.17) with two pair, Queens and Deuces
Seat 2: Lmao7 (big blind) showed [Ad 8s] and won ($2.18) with two pair, Queens and Deuces



PokerStars Zoom Hand #236524561809:  Hold'em No Limit ($0.25/$0.50) - 2022/06/02 15:41:02 ET
Table 'C Carinae' 2-max Seat #1 is the button
Seat 1: Lmao7 ($57.77 in chips) 
Seat 2: Lorpugo ($34.52 in chips) 
Lmao7: posts small blind $0.25
Lorpugo: posts big blind $0.50
*** HOLE CARDS ***
Dealt to Lorpugo [6c Td]
Lmao7: raises $0.75 to $1.25
Lorpugo: folds 
Uncalled bet ($0.75) returned to Lmao7
Lmao7 collected $1 from pot
Lmao7: doesn't show hand 
*** SUMMARY ***
Total pot $1 | Rake $0 
Seat 1: Lmao7 (button) (small blind) collected ($1)
Seat 2: Lorpugo (big blind) folded before Flop



PokerStars Zoom Hand #236524567554:  Hold'em No Limit ($0.25/$0.50) - 2022/06/02 15:41:17 ET
Table 'C Carinae' 2-max Seat #1 is the button
Seat 1: Lorpugo ($34.02 in chips) 
Seat 2: Lmao7 ($58.27 in chips) 
Lorpugo: posts small blind $0.25
Lmao7: posts big blind $0.50
*** HOLE CARDS ***
Dealt to Lorpugo [3h 8c]
Lorpugo: folds 
Uncalled bet ($0.25) returned to Lmao7
Lmao7 collected $0.50 from pot
Lmao7: doesn't show hand 
*** SUMMARY ***
Total pot $0.50 | Rake $0 
Seat 1: Lorpugo (button) (small blind) folded before Flop
Seat 2: Lmao7 (big blind) collected ($0.50)



PokerStars Zoom Hand #236524571170:  Hold'em No Limit ($0.25/$0.50) - 2022/06/02 15:41:26 ET
Table 'C Carinae' 2-max Seat #1 is the button
Seat 1: Mtaneli ($145.50 in chips) 
Seat 2: Lorpugo ($33.77 in chips) 
Mtaneli: posts small blind $0.25
Lorpugo: posts big blind $0.50
*** HOLE CARDS ***
Dealt to Lorpugo [2h Kc]
Mtaneli: folds 
Uncalled bet ($0.25) returned to Lorpugo
Lorpugo collected $0.50 from pot
Lorpugo: doesn't show hand 
*** SUMMARY ***
Total pot $0.50 | Rake $0 
Seat 1: Mtaneli (button) (small blind) folded before Flop
Seat 2: Lorpugo (big blind) collected ($0.50)



PokerStars Zoom Hand #236524573551:  Hold'em No Limit ($0.25/$0.50) - 2022/06/02 15:41:32 ET
Table 'C Carinae' 2-max Seat #1 is the button
Seat 1: idy_hu ($50.25 in chips) 
Seat 2: Lorpugo ($34.02 in chips) 
idy_hu: posts small blind $0.25
Lorpugo: posts big blind $0.50
*** HOLE CARDS ***
Dealt to Lorpugo [9h Kh]
idy_hu: raises $0.75 to $1.25
Lorpugo: calls $0.75
*** FLOP *** [Qh 7c 9c]
Lorpugo: checks 
idy_hu: checks 
*** TURN *** [Qh 7c 9c] [8c]
Lorpugo: checks 
idy_hu: checks 
*** RIVER *** [Qh 7c 9c 8c] [6s]
Lorpugo: checks 
idy_hu: checks 
*** SHOW DOWN ***
Lorpugo: shows [9h Kh] (a pair of Nines)
idy_hu: mucks hand 
Lorpugo collected $2.38 from pot
*** SUMMARY ***
Total pot $2.50 | Rake $0.12 
Board [Qh 7c 9c 8c 6s]
Seat 1: idy_hu (button) (small blind) mucked [4s Jh]
Seat 2: Lorpugo (big blind) showed [9h Kh] and won ($2.38) with a pair of Nines



PokerStars Zoom Hand #236524586837:  Hold'em No Limit ($0.25/$0.50) - 2022/06/02 15:42:06 ET
Table 'C Carinae' 2-max Seat #1 is the button
Seat 1: tanata932 ($82.56 in chips) 
Seat 2: Lorpugo ($35.15 in chips) 
tanata932: posts small blind $0.25
Lorpugo: posts big blind $0.50
*** HOLE CARDS ***
Dealt to Lorpugo [2s 4d]
tanata932: folds 
Uncalled bet ($0.25) returned to Lorpugo
Lorpugo collected $0.50 from pot
Lorpugo: doesn't show hand 
*** SUMMARY ***
Total pot $0.50 | Rake $0 
Seat 1: tanata932 (button) (small blind) folded before Flop
Seat 2: Lorpugo (big blind) collected ($0.50)



PokerStars Zoom Hand #236524589079:  Hold'em No Limit ($0.25/$0.50) - 2022/06/02 15:42:12 ET
Table 'C Carinae' 2-max Seat #1 is the button
Seat 1: Lorpugo ($35.40 in chips) 
Seat 2: OverCologne ($61.08 in chips) 
Lorpugo: posts small blind $0.25
OverCologne: posts big blind $0.50
*** HOLE CARDS ***
Dealt to Lorpugo [Qc 8c]
Lorpugo: raises $0.60 to $1.10
OverCologne: folds 
Uncalled bet ($0.60) returned to Lorpugo
Lorpugo collected $1 from pot
Lorpugo: doesn't show hand 
*** SUMMARY ***
Total pot $1 | Rake $0 
Seat 1: Lorpugo (button) (small blind) collected ($1)
Seat 2: OverCologne (big blind) folded before Flop



PokerStars Zoom Hand #236524594370:  Hold'em No Limit ($0.25/$0.50) - 2022/06/02 15:42:26 ET
Table 'C Carinae' 2-max Seat #1 is the button
Seat 1: Lorpugo ($35.90 in chips) 
Seat 2: friediii11 ($159.70 in chips) 
Lorpugo: posts small blind $0.25
friediii11: posts big blind $0.50
*** HOLE CARDS ***
Dealt to Lorpugo [2h 2c]
Lorpugo: raises $0.50 to $1
friediii11: raises $4 to $5
Lorpugo: raises $30.90 to $35.90 and is all-in
friediii11: calls $30.90
*** FLOP *** [4d 7c 8s]
*** TURN *** [4d 7c 8s] [4c]
*** RIVER *** [4d 7c 8s 4c] [5s]
*** SHOW DOWN ***
friediii11: shows [Ad Ks] (a pair of Fours)
Lorpugo: shows [2h 2c] (two pair, Fours and Deuces)
Lorpugo collected $71.05 from pot
*** SUMMARY ***
Total pot $71.80 | Rake $0.75 
Board [4d 7c 8s 4c 5s]
Seat 1: Lorpugo (button) (small blind) showed [2h 2c] and won ($71.05) with two pair, Fours and Deuces
Seat 2: friediii11 (big blind) showed [Ad Ks] and lost with a pair of Fours



PokerStars Zoom Hand #236524607176:  Hold'em No Limit ($0.25/$0.50) - 2022/06/02 15:42:59 ET
Table 'C Carinae' 2-max Seat #1 is the button
Seat 1: Artagas1 ($52.33 in chips) 
Seat 2: Lorpugo ($71.05 in chips) 
Artagas1: posts small blind $0.25
Lorpugo: posts big blind $0.50
*** HOLE CARDS ***
Dealt to Lorpugo [Ks Qh]
Artagas1: raises $0.75 to $1.25
Lorpugo: calls $0.75
*** FLOP *** [7d 9d 5h]
Lorpugo: checks 
Artagas1: bets $1.59
Lorpugo: folds 
Uncalled bet ($1.59) returned to Artagas1
Artagas1 collected $2.38 from pot
Artagas1: doesn't show hand 
*** SUMMARY ***
Total pot $2.50 | Rake $0.12 
Board [7d 9d 5h]
Seat 1: Artagas1 (button) (small blind) collected ($2.38)
Seat 2: Lorpugo (big blind) folded on the Flop



PokerStars Zoom Hand #236524614523:  Hold'em No Limit ($0.25/$0.50) - 2022/06/02 15:43:18 ET
Table 'C Carinae' 2-max Seat #1 is the button
Seat 1: Lorpugo ($69.80 in chips) 
Seat 2: MrSuperior ($127.96 in chips) 
Lorpugo: posts small blind $0.25
MrSuperior: posts big blind $0.50
*** HOLE CARDS ***
Dealt to Lorpugo [9s Qh]
Lorpugo: raises $0.50 to $1
MrSuperior: folds 
Uncalled bet ($0.50) returned to Lorpugo
Lorpugo collected $1 from pot
Lorpugo: doesn't show hand 
*** SUMMARY ***
Total pot $1 | Rake $0 
Seat 1: Lorpugo (button) (small blind) collected ($1)
Seat 2: MrSuperior (big blind) folded before Flop



PokerStars Zoom Hand #236524618522:  Hold'em No Limit ($0.25/$0.50) - 2022/06/02 15:43:28 ET
Table 'C Carinae' 2-max Seat #1 is the button
Seat 1: Lorpugo ($70.30 in chips) 
Seat 2: radopan ($50 in chips) 
Lorpugo: posts small blind $0.25
radopan: posts big blind $0.50
*** HOLE CARDS ***
Dealt to Lorpugo [7c Jh]
Lorpugo: raises $0.50 to $1
radopan: calls $0.50
*** FLOP *** [Kc 8s 3s]
radopan: checks 
Lorpugo: bets $0.63
radopan: folds 
Uncalled bet ($0.63) returned to Lorpugo
Lorpugo collected $1.90 from pot
Lorpugo: doesn't show hand 
*** SUMMARY ***
Total pot $2 | Rake $0.10 
Board [Kc 8s 3s]
Seat 1: Lorpugo (button) (small blind) collected ($1.90)
Seat 2: radopan (big blind) folded on the Flop



PokerStars Zoom Hand #236524813298:  Hold'em No Limit ($0.25/$0.50) - 2022/06/02 15:51:41 ET
Table 'C Carinae' 2-max Seat #1 is the button
Seat 1: Mtaneli ($179.52 in chips) 
Seat 2: Lorpugo ($25 in chips) 
Mtaneli: posts small blind $0.25
Lorpugo: posts big blind $0.50
*** HOLE CARDS ***
Dealt to Lorpugo [Qh 3s]
Mtaneli: raises $0.72 to $1.22
Lorpugo: folds 
Uncalled bet ($0.72) returned to Mtaneli
Mtaneli collected $1 from pot
Mtaneli: doesn't show hand 
*** SUMMARY ***
Total pot $1 | Rake $0 
Seat 1: Mtaneli (button) (small blind) collected ($1)
Seat 2: Lorpugo (big blind) folded before Flop



PokerStars Zoom Hand #236524816079:  Hold'em No Limit ($0.25/$0.50) - 2022/06/02 15:51:48 ET
Table 'C Carinae' 2-max Seat #1 is the button
Seat 1: Limerickey71 ($27.68 in chips) 
Seat 2: Lorpugo ($24.50 in chips) 
Limerickey71: posts small blind $0.25
Lorpugo: posts big blind $0.50
*** HOLE CARDS ***
Dealt to Lorpugo [6c Ks]
Limerickey71: raises $0.50 to $1
Lorpugo: calls $0.50
*** FLOP *** [Js 3h As]
Lorpugo: checks 
Limerickey71: bets $1
Lorpugo: folds 
Uncalled bet ($1) returned to Limerickey71
Limerickey71 collected $1.90 from pot
Limerickey71: doesn't show hand 
*** SUMMARY ***
Total pot $2 | Rake $0.10 
Board [Js 3h As]
Seat 1: Limerickey71 (button) (small blind) collected ($1.90)
Seat 2: Lorpugo (big blind) folded on the Flop



PokerStars Zoom Hand #236524824145:  Hold'em No Limit ($0.25/$0.50) - 2022/06/02 15:52:09 ET
Table 'C Carinae' 2-max Seat #1 is the button
Seat 1: Lorpugo ($23.50 in chips) 
Seat 2: OverCologne ($68.42 in chips) 
Lorpugo: posts small blind $0.25
OverCologne: posts big blind $0.50
*** HOLE CARDS ***
Dealt to Lorpugo [Ks Tc]
Lorpugo: raises $0.50 to $1
OverCologne: calls $0.50
*** FLOP *** [8c 6h 3s]
OverCologne: checks 
Lorpugo: checks 
*** TURN *** [8c 6h 3s] [Kh]
OverCologne: checks 
Lorpugo: bets $0.63
OverCologne: folds 
Uncalled bet ($0.63) returned to Lorpugo
Lorpugo collected $1.90 from pot
Lorpugo: doesn't show hand 
*** SUMMARY ***
Total pot $2 | Rake $0.10 
Board [8c 6h 3s Kh]
Seat 1: Lorpugo (button) (small blind) collected ($1.90)
Seat 2: OverCologne (big blind) folded on the Turn



PokerStars Zoom Hand #236524833135:  Hold'em No Limit ($0.25/$0.50) - 2022/06/02 15:52:33 ET
Table 'C Carinae' 2-max Seat #1 is the button
Seat 1: Lorpugo ($24.40 in chips) 
Seat 2: friediii11 ($88.33 in chips) 
Lorpugo: posts small blind $0.25
friediii11: posts big blind $0.50
*** HOLE CARDS ***
Dealt to Lorpugo [Kc 2h]
Lorpugo: raises $0.50 to $1
friediii11: calls $0.50
*** FLOP *** [9c 8h Kd]
friediii11: checks 
Lorpugo: checks 
*** TURN *** [9c 8h Kd] [Tc]
friediii11: checks 
Lorpugo: bets $1
friediii11: calls $1
*** RIVER *** [9c 8h Kd Tc] [4h]
friediii11: checks 
Lorpugo: bets $3
friediii11: calls $3
*** SHOW DOWN ***
Lorpugo: shows [Kc 2h] (a pair of Kings)
friediii11: mucks hand 
Lorpugo collected $9.50 from pot
*** SUMMARY ***
Total pot $10 | Rake $0.50 
Board [9c 8h Kd Tc 4h]
Seat 1: Lorpugo (button) (small blind) showed [Kc 2h] and won ($9.50) with a pair of Kings
Seat 2: friediii11 (big blind) mucked [Jd 9s]



PokerStars Zoom Hand #236524853772:  Hold'em No Limit ($0.25/$0.50) - 2022/06/02 15:53:27 ET
Table 'C Carinae' 2-max Seat #1 is the button
Seat 1: MrSuperior ($162.46 in chips) 
Seat 2: Lorpugo ($28.90 in chips) 
MrSuperior: posts small blind $0.25
Lorpugo: posts big blind $0.50
*** HOLE CARDS ***
Dealt to Lorpugo [5s 7c]
MrSuperior: calls $0.25
Lorpugo: checks 
*** FLOP *** [9d 3h 6d]
Lorpugo: checks 
MrSuperior: bets $1
Lorpugo: calls $1
*** TURN *** [9d 3h 6d] [5c]
Lorpugo: checks 
MrSuperior: bets $4
Lorpugo: folds 
Uncalled bet ($4) returned to MrSuperior
MrSuperior collected $2.85 from pot
MrSuperior: doesn't show hand 
*** SUMMARY ***
Total pot $3 | Rake $0.15 
Board [9d 3h 6d 5c]
Seat 1: MrSuperior (button) (small blind) collected ($2.85)
Seat 2: Lorpugo (big blind) folded on the Turn



PokerStars Zoom Hand #236524870953:  Hold'em No Limit ($0.25/$0.50) - 2022/06/02 15:54:11 ET
Table 'C Carinae' 2-max Seat #1 is the button
Seat 1: M4GPI3 ($52.95 in chips) 
Seat 2: Lorpugo ($27.40 in chips) 
M4GPI3: posts small blind $0.25
Lorpugo: posts big blind $0.50
*** HOLE CARDS ***
Dealt to Lorpugo [Kd Jd]
M4GPI3: raises $0.50 to $1
Lorpugo: raises $2.50 to $3.50
M4GPI3: calls $2.50
*** FLOP *** [7h Qh Td]
Lorpugo: checks 
M4GPI3: bets $3.33
Lorpugo: raises $20.57 to $23.90 and is all-in
M4GPI3: calls $20.57
*** TURN *** [7h Qh Td] [Kh]
*** RIVER *** [7h Qh Td Kh] [7d]
*** SHOW DOWN ***
Lorpugo: shows [Kd Jd] (two pair, Kings and Sevens)
M4GPI3: shows [Qs Th] (two pair, Queens and Tens)
Lorpugo collected $54.05 from pot
*** SUMMARY ***
Total pot $54.80 | Rake $0.75 
Board [7h Qh Td Kh 7d]
Seat 1: M4GPI3 (button) (small blind) showed [Qs Th] and lost with two pair, Queens and Tens
Seat 2: Lorpugo (big blind) showed [Kd Jd] and won ($54.05) with two pair, Kings and Sevens



PokerStars Zoom Hand #236524895574:  Hold'em No Limit ($0.25/$0.50) - 2022/06/02 15:54:57 ET
Table 'C Carinae' 2-max Seat #1 is the button
Seat 1: Lorpugo ($54.05 in chips) 
Seat 2: M4GPI3 ($50 in chips) 
Lorpugo: posts small blind $0.25
M4GPI3: posts big blind $0.50
*** HOLE CARDS ***
Dealt to Lorpugo [Th 5h]
Lorpugo: raises $0.50 to $1
M4GPI3: calls $0.50
*** FLOP *** [7d Js 6d]
M4GPI3: checks 
Lorpugo: checks 
*** TURN *** [7d Js 6d] [Tc]
M4GPI3: checks 
Lorpugo: bets $1.10
M4GPI3: folds 
Uncalled bet ($1.10) returned to Lorpugo
Lorpugo collected $1.90 from pot
Lorpugo: doesn't show hand 
*** SUMMARY ***
Total pot $2 | Rake $0.10 
Board [7d Js 6d Tc]
Seat 1: Lorpugo (button) (small blind) collected ($1.90)
Seat 2: M4GPI3 (big blind) folded on the Turn



PokerStars Zoom Hand #236524912825:  Hold'em No Limit ($0.25/$0.50) - 2022/06/02 15:55:52 ET
Table 'C Carinae' 2-max Seat #1 is the button
Seat 1: friediii11 ($77.21 in chips) 
Seat 2: Lorpugo ($25 in chips) 
friediii11: posts small blind $0.25
Lorpugo: posts big blind $0.50
*** HOLE CARDS ***
Dealt to Lorpugo [5c 7d]
friediii11: raises $0.75 to $1.25
Lorpugo: folds 
Uncalled bet ($0.75) returned to friediii11
friediii11 collected $1 from pot
friediii11: doesn't show hand 
*** SUMMARY ***
Total pot $1 | Rake $0 
Seat 1: friediii11 (button) (small blind) collected ($1)
Seat 2: Lorpugo (big blind) folded before Flop



PokerStars Zoom Hand #236524915725:  Hold'em No Limit ($0.25/$0.50) - 2022/06/02 15:56:01 ET
Table 'C Carinae' 2-max Seat #1 is the button
Seat 1: idy_hu ($52.58 in chips) 
Seat 2: Lorpugo ($24.50 in chips) 
idy_hu: posts small blind $0.25
Lorpugo: posts big blind $0.50
*** HOLE CARDS ***
Dealt to Lorpugo [Ah 2d]
idy_hu: folds 
Uncalled bet ($0.25) returned to Lorpugo
Lorpugo collected $0.50 from pot
Lorpugo: doesn't show hand 
*** SUMMARY ***
Total pot $0.50 | Rake $0 
Seat 1: idy_hu (button) (small blind) folded before Flop
Seat 2: Lorpugo (big blind) collected ($0.50)



PokerStars Zoom Hand #236524917442:  Hold'em No Limit ($0.25/$0.50) - 2022/06/02 15:56:08 ET
Table 'C Carinae' 2-max Seat #1 is the button
Seat 1: Lorpugo ($24.75 in chips) 
Seat 2: jamesa261 ($50.63 in chips) 
Lorpugo: posts small blind $0.25
jamesa261: posts big blind $0.50
*** HOLE CARDS ***
Dealt to Lorpugo [Qd 7s]
Lorpugo: raises $0.50 to $1
jamesa261: folds 
Uncalled bet ($0.50) returned to Lorpugo
Lorpugo collected $1 from pot
Lorpugo: doesn't show hand 
*** SUMMARY ***
Total pot $1 | Rake $0 
Seat 1: Lorpugo (button) (small blind) collected ($1)
Seat 2: jamesa261 (big blind) folded before Flop



PokerStars Zoom Hand #236524920344:  Hold'em No Limit ($0.25/$0.50) - 2022/06/02 15:56:18 ET
Table 'C Carinae' 2-max Seat #1 is the button
Seat 1: Lorpugo ($25.25 in chips) 
Seat 2: idy_hu ($50.50 in chips) 
Lorpugo: posts small blind $0.25
idy_hu: posts big blind $0.50
*** HOLE CARDS ***
Dealt to Lorpugo [9d 4c]
Lorpugo: folds 
Uncalled bet ($0.25) returned to idy_hu
idy_hu collected $0.50 from pot
idy_hu: doesn't show hand 
*** SUMMARY ***
Total pot $0.50 | Rake $0 
Seat 1: Lorpugo (button) (small blind) folded before Flop
Seat 2: idy_hu (big blind) collected ($0.50)



PokerStars Zoom Hand #236524922440:  Hold'em No Limit ($0.25/$0.50) - 2022/06/02 15:56:25 ET
Table 'C Carinae' 2-max Seat #1 is the button
Seat 1: idy_hu ($53.08 in chips) 
Seat 2: Lorpugo ($25 in chips) 
idy_hu: posts small blind $0.25
Lorpugo: posts big blind $0.50
*** HOLE CARDS ***
Dealt to Lorpugo [2d Kd]
idy_hu: raises $0.75 to $1.25
Lorpugo: calls $0.75
*** FLOP *** [Ac Js Qd]
Lorpugo: checks 
idy_hu: checks 
*** TURN *** [Ac Js Qd] [Jd]
Lorpugo: bets $0.79
idy_hu: folds 
Uncalled bet ($0.79) returned to Lorpugo
Lorpugo collected $2.38 from pot
Lorpugo: doesn't show hand 
*** SUMMARY ***
Total pot $2.50 | Rake $0.12 
Board [Ac Js Qd Jd]
Seat 1: idy_hu (button) (small blind) folded on the Turn
Seat 2: Lorpugo (big blind) collected ($2.38)



PokerStars Zoom Hand #236524932401:  Hold'em No Limit ($0.25/$0.50) - 2022/06/02 15:56:59 ET
Table 'C Carinae' 2-max Seat #1 is the button
Seat 1: Lorpugo ($26.13 in chips) 
Seat 2: idy_hu ($51.83 in chips) 
Lorpugo: posts small blind $0.25
idy_hu: posts big blind $0.50
*** HOLE CARDS ***
Dealt to Lorpugo [Jh Ks]
Lorpugo: raises $0.60 to $1.10
idy_hu: calls $0.60
*** FLOP *** [Kd 6c 7c]
idy_hu: checks 
Lorpugo: checks 
*** TURN *** [Kd 6c 7c] [Tc]
idy_hu: checks 
Lorpugo: bets $1.50
idy_hu: calls $1.50
*** RIVER *** [Kd 6c 7c Tc] [4h]
idy_hu: checks 
Lorpugo: bets $2.50
idy_hu: folds 
Uncalled bet ($2.50) returned to Lorpugo
Lorpugo collected $4.94 from pot
Lorpugo: doesn't show hand 
*** SUMMARY ***
Total pot $5.20 | Rake $0.26 
Board [Kd 6c 7c Tc 4h]
Seat 1: Lorpugo (button) (small blind) collected ($4.94)
Seat 2: idy_hu (big blind) folded on the River



PokerStars Zoom Hand #236524945105:  Hold'em No Limit ($0.25/$0.50) - 2022/06/02 15:57:43 ET
Table 'C Carinae' 2-max Seat #1 is the button
Seat 1: tanata932 ($97.23 in chips) 
Seat 2: Lorpugo ($28.47 in chips) 
tanata932: posts small blind $0.25
Lorpugo: posts big blind $0.50
*** HOLE CARDS ***
Dealt to Lorpugo [Tc 6s]
tanata932: raises $1 to $1.50
Lorpugo: folds 
Uncalled bet ($1) returned to tanata932
tanata932 collected $1 from pot
tanata932: doesn't show hand 
*** SUMMARY ***
Total pot $1 | Rake $0 
Seat 1: tanata932 (button) (small blind) collected ($1)
Seat 2: Lorpugo (big blind) folded before Flop



PokerStars Zoom Hand #236524948277:  Hold'em No Limit ($0.25/$0.50) - 2022/06/02 15:57:54 ET
Table 'C Carinae' 2-max Seat #1 is the button
Seat 1: Lorpugo ($27.97 in chips) 
Seat 2: idy_hu ($54.12 in chips) 
Lorpugo: posts small blind $0.25
idy_hu: posts big blind $0.50
*** HOLE CARDS ***
Dealt to Lorpugo [5d As]
Lorpugo: raises $0.60 to $1.10
idy_hu: raises $3.40 to $4.50
Lorpugo: folds 
Uncalled bet ($3.40) returned to idy_hu
idy_hu collected $2.20 from pot
idy_hu: doesn't show hand 
*** SUMMARY ***
Total pot $2.20 | Rake $0 
Seat 1: Lorpugo (button) (small blind) folded before Flop
Seat 2: idy_hu (big blind) collected ($2.20)



PokerStars Zoom Hand #236524953222:  Hold'em No Limit ($0.25/$0.50) - 2022/06/02 15:58:11 ET
Table 'C Carinae' 2-max Seat #1 is the button
Seat 1: OverCologne ($72.74 in chips) 
Seat 2: Lorpugo ($26.87 in chips) 
OverCologne: posts small blind $0.25
Lorpugo: posts big blind $0.50
*** HOLE CARDS ***
Dealt to Lorpugo [Th Qh]
OverCologne: folds 
Uncalled bet ($0.25) returned to Lorpugo
Lorpugo collected $0.50 from pot
Lorpugo: doesn't show hand 
*** SUMMARY ***
Total pot $0.50 | Rake $0 
Seat 1: OverCologne (button) (small blind) folded before Flop
Seat 2: Lorpugo (big blind) collected ($0.50)



PokerStars Zoom Hand #236524954981:  Hold'em No Limit ($0.25/$0.50) - 2022/06/02 15:58:17 ET
Table 'C Carinae' 2-max Seat #1 is the button
Seat 1: Limerickey71 ($14.69 in chips) 
Seat 2: Lorpugo ($27.12 in chips) 
Limerickey71: posts small blind $0.25
Lorpugo: posts big blind $0.50
*** HOLE CARDS ***
Dealt to Lorpugo [5s 5h]
Limerickey71: calls $0.25
Lorpugo: checks 
*** FLOP *** [7s 2s 7d]
Lorpugo: checks 
Limerickey71: checks 
*** TURN *** [7s 2s 7d] [Th]
Lorpugo: checks 
Limerickey71: checks 
*** RIVER *** [7s 2s 7d Th] [8s]
Lorpugo: checks 
Limerickey71: checks 
*** SHOW DOWN ***
Lorpugo: shows [5s 5h] (two pair, Sevens and Fives)
Limerickey71: mucks hand 
Lorpugo collected $0.95 from pot
*** SUMMARY ***
Total pot $1 | Rake $0.05 
Board [7s 2s 7d Th 8s]
Seat 1: Limerickey71 (button) (small blind) mucked [3d 5d]
Seat 2: Lorpugo (big blind) showed [5s 5h] and won ($0.95) with two pair, Sevens and Fives



PokerStars Zoom Hand #236524964084:  Hold'em No Limit ($0.25/$0.50) - 2022/06/02 15:58:48 ET
Table 'C Carinae' 2-max Seat #1 is the button
Seat 1: Lorpugo ($27.57 in chips) 
Seat 2: Hannisy1991 ($72.14 in chips) 
Lorpugo: posts small blind $0.25
Hannisy1991: posts big blind $0.50
*** HOLE CARDS ***
Dealt to Lorpugo [7h 4h]
Lorpugo: raises $0.50 to $1
Hannisy1991: calls $0.50
*** FLOP *** [Ts 4d 2s]
Hannisy1991: checks 
Lorpugo: bets $0.63
Hannisy1991: calls $0.63
*** TURN *** [Ts 4d 2s] [3c]
Hannisy1991: checks 
Lorpugo: bets $1.55
Hannisy1991: raises $3.95 to $5.50
Lorpugo: folds 
Uncalled bet ($3.95) returned to Hannisy1991
Hannisy1991 collected $5.96 from pot
Hannisy1991: doesn't show hand 
*** SUMMARY ***
Total pot $6.36 | Rake $0.40 
Board [Ts 4d 2s 3c]
Seat 1: Lorpugo (button) (small blind) folded on the Turn
Seat 2: Hannisy1991 (big blind) collected ($5.96)



PokerStars Zoom Hand #236524976532:  Hold'em No Limit ($0.25/$0.50) - 2022/06/02 15:59:32 ET
Table 'C Carinae' 2-max Seat #1 is the button
Seat 1: Lorpugo ($24.39 in chips) 
Seat 2: candonga ($50.25 in chips) 
Lorpugo: posts small blind $0.25
candonga: posts big blind $0.50
*** HOLE CARDS ***
Dealt to Lorpugo [Ah 2s]
Lorpugo: raises $0.60 to $1.10
candonga: folds 
Uncalled bet ($0.60) returned to Lorpugo
Lorpugo collected $1 from pot
Lorpugo: doesn't show hand 
*** SUMMARY ***
Total pot $1 | Rake $0 
Seat 1: Lorpugo (button) (small blind) collected ($1)
Seat 2: candonga (big blind) folded before Flop



PokerStars Zoom Hand #236524979466:  Hold'em No Limit ($0.25/$0.50) - 2022/06/02 15:59:42 ET
Table 'C Carinae' 2-max Seat #1 is the button
Seat 1: candonga ($50 in chips) 
Seat 2: Lorpugo ($24.89 in chips) 
candonga: posts small blind $0.25
Lorpugo: posts big blind $0.50
*** HOLE CARDS ***
Dealt to Lorpugo [7s 5d]
candonga: raises $1 to $1.50
Lorpugo: folds 
Uncalled bet ($1) returned to candonga
candonga collected $1 from pot
candonga: doesn't show hand 
*** SUMMARY ***
Total pot $1 | Rake $0 
Seat 1: candonga (button) (small blind) collected ($1)
Seat 2: Lorpugo (big blind) folded before Flop



PokerStars Zoom Hand #236524983535:  Hold'em No Limit ($0.25/$0.50) - 2022/06/02 15:59:56 ET
Table 'C Carinae' 2-max Seat #1 is the button
Seat 1: Lorpugo ($24.39 in chips) 
Seat 2: OverCologne ($50.57 in chips) 
Lorpugo: posts small blind $0.25
OverCologne: posts big blind $0.50
*** HOLE CARDS ***
Dealt to Lorpugo [9c 8h]
Lorpugo: raises $0.60 to $1.10
OverCologne: calls $0.60
*** FLOP *** [Tc 5c Ac]
OverCologne: checks 
Lorpugo: bets $0.69
OverCologne: folds 
Uncalled bet ($0.69) returned to Lorpugo
Lorpugo collected $2.09 from pot
Lorpugo: doesn't show hand 
*** SUMMARY ***
Total pot $2.20 | Rake $0.11 
Board [Tc 5c Ac]
Seat 1: Lorpugo (button) (small blind) collected ($2.09)
Seat 2: OverCologne (big blind) folded on the Flop



PokerStars Zoom Hand #236524991979:  Hold'em No Limit ($0.25/$0.50) - 2022/06/02 16:00:24 ET
Table 'C Carinae' 2-max Seat #1 is the button
Seat 1: honeythief11 ($16.80 in chips) 
Seat 2: Lorpugo ($25.38 in chips) 
honeythief11: posts small blind $0.25
Lorpugo: posts big blind $0.50
*** HOLE CARDS ***
Dealt to Lorpugo [6c Qh]
honeythief11: raises $16.30 to $16.80 and is all-in
Lorpugo: folds 
Uncalled bet ($16.30) returned to honeythief11
honeythief11 collected $1 from pot
honeythief11: doesn't show hand 
*** SUMMARY ***
Total pot $1 | Rake $0 
Seat 1: honeythief11 (button) (small blind) collected ($1)
Seat 2: Lorpugo (big blind) folded before Flop



PokerStars Zoom Hand #236524994423:  Hold'em No Limit ($0.25/$0.50) - 2022/06/02 16:00:32 ET
Table 'C Carinae' 2-max Seat #1 is the button
Seat 1: Artagas1 ($84.98 in chips) 
Seat 2: Lorpugo ($24.88 in chips) 
Artagas1: posts small blind $0.25
Lorpugo: posts big blind $0.50
*** HOLE CARDS ***
Dealt to Lorpugo [5s 3h]
Artagas1: raises $0.75 to $1.25
Lorpugo: folds 
Uncalled bet ($0.75) returned to Artagas1
Artagas1 collected $1 from pot
Artagas1: doesn't show hand 
*** SUMMARY ***
Total pot $1 | Rake $0 
Seat 1: Artagas1 (button) (small blind) collected ($1)
Seat 2: Lorpugo (big blind) folded before Flop



PokerStars Zoom Hand #236524997845:  Hold'em No Limit ($0.25/$0.50) - 2022/06/02 16:00:43 ET
Table 'C Carinae' 2-max Seat #1 is the button
Seat 1: Lorpugo ($24.38 in chips) 
Seat 2: idy_hu ($57.96 in chips) 
Lorpugo: posts small blind $0.25
idy_hu: posts big blind $0.50
*** HOLE CARDS ***
Dealt to Lorpugo [3s 9s]
Lorpugo: raises $0.60 to $1.10
idy_hu: calls $0.60
*** FLOP *** [Ac As 8s]
idy_hu: checks 
Lorpugo: bets $0.69
idy_hu: calls $0.69
*** TURN *** [Ac As 8s] [5d]
idy_hu: checks 
Lorpugo: bets $1.12
idy_hu: folds 
Uncalled bet ($1.12) returned to Lorpugo
Lorpugo collected $3.40 from pot
Lorpugo: doesn't show hand 
*** SUMMARY ***
Total pot $3.58 | Rake $0.18 
Board [Ac As 8s 5d]
Seat 1: Lorpugo (button) (small blind) collected ($3.40)
Seat 2: idy_hu (big blind) folded on the Turn



PokerStars Zoom Hand #236525011824:  Hold'em No Limit ($0.25/$0.50) - 2022/06/02 16:01:23 ET
Table 'C Carinae' 2-max Seat #1 is the button
Seat 1: Artagas1 ($108.91 in chips) 
Seat 2: Lorpugo ($25.99 in chips) 
Artagas1: posts small blind $0.25
Lorpugo: posts big blind $0.50
*** HOLE CARDS ***
Dealt to Lorpugo [8c 4h]
Artagas1: folds 
Uncalled bet ($0.25) returned to Lorpugo
Lorpugo collected $0.50 from pot
Lorpugo: doesn't show hand 
*** SUMMARY ***
Total pot $0.50 | Rake $0 
Seat 1: Artagas1 (button) (small blind) folded before Flop
Seat 2: Lorpugo (big blind) collected ($0.50)



PokerStars Zoom Hand #236525015363:  Hold'em No Limit ($0.25/$0.50) - 2022/06/02 16:01:33 ET
Table 'C Carinae' 2-max Seat #1 is the button
Seat 1: Lorpugo ($26.24 in chips) 
Seat 2: Artagas1 ($91.35 in chips) 
Lorpugo: posts small blind $0.25
Artagas1: posts big blind $0.50
*** HOLE CARDS ***
Dealt to Lorpugo [3s 6h]
Lorpugo: folds 
Uncalled bet ($0.25) returned to Artagas1
Artagas1 collected $0.50 from pot
Artagas1: doesn't show hand 
*** SUMMARY ***
Total pot $0.50 | Rake $0 
Seat 1: Lorpugo (button) (small blind) folded before Flop
Seat 2: Artagas1 (big blind) collected ($0.50)



PokerStars Zoom Hand #236525018252:  Hold'em No Limit ($0.25/$0.50) - 2022/06/02 16:01:41 ET
Table 'C Carinae' 2-max Seat #1 is the button
Seat 1: Lorpugo ($25.99 in chips) 
Seat 2: MrSuperior ($193.04 in chips) 
Lorpugo: posts small blind $0.25
MrSuperior: posts big blind $0.50
*** HOLE CARDS ***
Dealt to Lorpugo [Td 4h]
Lorpugo: folds 
Uncalled bet ($0.25) returned to MrSuperior
MrSuperior collected $0.50 from pot
MrSuperior: doesn't show hand 
*** SUMMARY ***
Total pot $0.50 | Rake $0 
Seat 1: Lorpugo (button) (small blind) folded before Flop
Seat 2: MrSuperior (big blind) collected ($0.50)



PokerStars Zoom Hand #236525021024:  Hold'em No Limit ($0.25/$0.50) - 2022/06/02 16:01:49 ET
Table 'C Carinae' 2-max Seat #1 is the button
Seat 1: Artagas1 ($92.10 in chips) 
Seat 2: Lorpugo ($25.74 in chips) 
Artagas1: posts small blind $0.25
Lorpugo: posts big blind $0.50
*** HOLE CARDS ***
Dealt to Lorpugo [7c 6d]
Artagas1: raises $0.75 to $1.25
Lorpugo: calls $0.75
*** FLOP *** [7h 5c 3d]
Lorpugo: checks 
Artagas1: bets $1.19
Lorpugo: raises $23.30 to $24.49 and is all-in
Artagas1: folds 
Uncalled bet ($23.30) returned to Lorpugo
Lorpugo collected $4.64 from pot
Lorpugo: doesn't show hand 
*** SUMMARY ***
Total pot $4.88 | Rake $0.24 
Board [7h 5c 3d]
Seat 1: Artagas1 (button) (small blind) folded on the Flop
Seat 2: Lorpugo (big blind) collected ($4.64)



PokerStars Zoom Hand #236525035538:  Hold'em No Limit ($0.25/$0.50) - 2022/06/02 16:02:28 ET
Table 'C Carinae' 2-max Seat #1 is the button
Seat 1: Lorpugo ($27.94 in chips) 
Seat 2: Artagas1 ($89.66 in chips) 
Lorpugo: posts small blind $0.25
Artagas1: posts big blind $0.50
*** HOLE CARDS ***
Dealt to Lorpugo [Jc 6c]
Lorpugo: raises $0.60 to $1.10
Artagas1: folds 
Uncalled bet ($0.60) returned to Lorpugo
Lorpugo collected $1 from pot
Lorpugo: doesn't show hand 
*** SUMMARY ***
Total pot $1 | Rake $0 
Seat 1: Lorpugo (button) (small blind) collected ($1)
Seat 2: Artagas1 (big blind) folded before Flop



PokerStars Zoom Hand #236525039310:  Hold'em No Limit ($0.25/$0.50) - 2022/06/02 16:02:38 ET
Table 'C Carinae' 2-max Seat #1 is the button
Seat 1: Artagas1 ($89.16 in chips) 
Seat 2: Lorpugo ($28.44 in chips) 
Artagas1: posts small blind $0.25
Lorpugo: posts big blind $0.50
*** HOLE CARDS ***
Dealt to Lorpugo [3h 4s]
Artagas1: folds 
Uncalled bet ($0.25) returned to Lorpugo
Lorpugo collected $0.50 from pot
Lorpugo: doesn't show hand 
*** SUMMARY ***
Total pot $0.50 | Rake $0 
Seat 1: Artagas1 (button) (small blind) folded before Flop
Seat 2: Lorpugo (big blind) collected ($0.50)



PokerStars Zoom Hand #236525042688:  Hold'em No Limit ($0.25/$0.50) - 2022/06/02 16:02:47 ET
Table 'C Carinae' 2-max Seat #1 is the button
Seat 1: Lorpugo ($28.69 in chips) 
Seat 2: Artagas1 ($88.91 in chips) 
Lorpugo: posts small blind $0.25
Artagas1: posts big blind $0.50
*** HOLE CARDS ***
Dealt to Lorpugo [2s Qc]
Lorpugo: folds 
Uncalled bet ($0.25) returned to Artagas1
Artagas1 collected $0.50 from pot
Artagas1: doesn't show hand 
*** SUMMARY ***
Total pot $0.50 | Rake $0 
Seat 1: Lorpugo (button) (small blind) folded before Flop
Seat 2: Artagas1 (big blind) collected ($0.50)



PokerStars Zoom Hand #236525045771:  Hold'em No Limit ($0.25/$0.50) - 2022/06/02 16:02:55 ET
Table 'C Carinae' 2-max Seat #1 is the button
Seat 1: radopan ($55.80 in chips) 
Seat 2: Lorpugo ($28.44 in chips) 
radopan: posts small blind $0.25
Lorpugo: posts big blind $0.50
*** HOLE CARDS ***
Dealt to Lorpugo [Td 5s]
radopan: raises $0.50 to $1
Lorpugo: folds 
Uncalled bet ($0.50) returned to radopan
radopan collected $1 from pot
radopan: doesn't show hand 
*** SUMMARY ***
Total pot $1 | Rake $0 
Seat 1: radopan (button) (small blind) collected ($1)
Seat 2: Lorpugo (big blind) folded before Flop



PokerStars Zoom Hand #236525051935:  Hold'em No Limit ($0.25/$0.50) - 2022/06/02 16:03:12 ET
Table 'C Carinae' 2-max Seat #1 is the button
Seat 1: Lorpugo ($27.94 in chips) 
Seat 2: Limerickey71 ($10.64 in chips) 
Lorpugo: posts small blind $0.25
Limerickey71: posts big blind $0.50
*** HOLE CARDS ***
Dealt to Lorpugo [5c 9d]
Lorpugo: folds 
Uncalled bet ($0.25) returned to Limerickey71
Limerickey71 collected $0.50 from pot
Limerickey71: doesn't show hand 
*** SUMMARY ***
Total pot $0.50 | Rake $0 
Seat 1: Lorpugo (button) (small blind) folded before Flop
Seat 2: Limerickey71 (big blind) collected ($0.50)



PokerStars Zoom Hand #236525055456:  Hold'em No Limit ($0.25/$0.50) - 2022/06/02 16:03:21 ET
Table 'C Carinae' 2-max Seat #1 is the button
Seat 1: Limerickey71 ($10.89 in chips) 
Seat 2: Lorpugo ($27.69 in chips) 
Limerickey71: posts small blind $0.25
Lorpugo: posts big blind $0.50
*** HOLE CARDS ***
Dealt to Lorpugo [9c 7s]
Limerickey71: calls $0.25
Lorpugo: checks 
*** FLOP *** [4c 2s Qd]
Lorpugo: checks 
Limerickey71: bets $1
Lorpugo: folds 
Uncalled bet ($1) returned to Limerickey71
Limerickey71 collected $0.95 from pot
Limerickey71: doesn't show hand 
*** SUMMARY ***
Total pot $1 | Rake $0.05 
Board [4c 2s Qd]
Seat 1: Limerickey71 (button) (small blind) collected ($0.95)
Seat 2: Lorpugo (big blind) folded on the Flop



PokerStars Zoom Hand #236525063478:  Hold'em No Limit ($0.25/$0.50) - 2022/06/02 16:03:42 ET
Table 'C Carinae' 2-max Seat #1 is the button
Seat 1: Lorpugo ($27.19 in chips) 
Seat 2: candonga ($57.80 in chips) 
Lorpugo: posts small blind $0.25
candonga: posts big blind $0.50
*** HOLE CARDS ***
Dealt to Lorpugo [3s 2h]
Lorpugo: folds 
Uncalled bet ($0.25) returned to candonga
candonga collected $0.50 from pot
candonga: doesn't show hand 
*** SUMMARY ***
Total pot $0.50 | Rake $0 
Seat 1: Lorpugo (button) (small blind) folded before Flop
Seat 2: candonga (big blind) collected ($0.50)



PokerStars Zoom Hand #236525066185:  Hold'em No Limit ($0.25/$0.50) - 2022/06/02 16:03:49 ET
Table 'C Carinae' 2-max Seat #1 is the button
Seat 1: MrSuperior ($197.57 in chips) 
Seat 2: Lorpugo ($26.94 in chips) 
MrSuperior: posts small blind $0.25
Lorpugo: posts big blind $0.50
*** HOLE CARDS ***
Dealt to Lorpugo [Ad 7h]
MrSuperior: folds 
Uncalled bet ($0.25) returned to Lorpugo
Lorpugo collected $0.50 from pot
Lorpugo: doesn't show hand 
*** SUMMARY ***
Total pot $0.50 | Rake $0 
Seat 1: MrSuperior (button) (small blind) folded before Flop
Seat 2: Lorpugo (big blind) collected ($0.50)



PokerStars Zoom Hand #236525068618:  Hold'em No Limit ($0.25/$0.50) - 2022/06/02 16:03:55 ET
Table 'C Carinae' 2-max Seat #1 is the button
Seat 1: Lorpugo ($27.19 in chips) 
Seat 2: paddyisthebest ($37.80 in chips) 
Lorpugo: posts small blind $0.25
paddyisthebest: posts big blind $0.50
*** HOLE CARDS ***
Dealt to Lorpugo [9h 7s]
Lorpugo: raises $0.60 to $1.10
paddyisthebest: folds 
Uncalled bet ($0.60) returned to Lorpugo
Lorpugo collected $1 from pot
Lorpugo: doesn't show hand 
*** SUMMARY ***
Total pot $1 | Rake $0 
Seat 1: Lorpugo (button) (small blind) collected ($1)
Seat 2: paddyisthebest (big blind) folded before Flop



PokerStars Zoom Hand #236525072444:  Hold'em No Limit ($0.25/$0.50) - 2022/06/02 16:04:05 ET
Table 'C Carinae' 2-max Seat #1 is the button
Seat 1: tanata932 ($102.75 in chips) 
Seat 2: Lorpugo ($27.69 in chips) 
tanata932: posts small blind $0.25
Lorpugo: posts big blind $0.50
*** HOLE CARDS ***
Dealt to Lorpugo [As 9d]
tanata932: raises $1 to $1.50
Lorpugo: calls $1
*** FLOP *** [4d 4h Jc]
Lorpugo: checks 
tanata932: checks 
*** TURN *** [4d 4h Jc] [8c]
Lorpugo: bets $0.75
tanata932: folds 
Uncalled bet ($0.75) returned to Lorpugo
Lorpugo collected $2.85 from pot
Lorpugo: doesn't show hand 
*** SUMMARY ***
Total pot $3 | Rake $0.15 
Board [4d 4h Jc 8c]
Seat 1: tanata932 (button) (small blind) folded on the Turn
Seat 2: Lorpugo (big blind) collected ($2.85)



PokerStars Zoom Hand #236525088800:  Hold'em No Limit ($0.25/$0.50) - 2022/06/02 16:04:46 ET
Table 'C Carinae' 2-max Seat #1 is the button
Seat 1: Lorpugo ($29.04 in chips) 
Seat 2: tanata932 ($101.25 in chips) 
Lorpugo: posts small blind $0.25
tanata932: posts big blind $0.50
*** HOLE CARDS ***
Dealt to Lorpugo [3c Jh]
Lorpugo: folds 
Uncalled bet ($0.25) returned to tanata932
tanata932 collected $0.50 from pot
tanata932: doesn't show hand 
*** SUMMARY ***
Total pot $0.50 | Rake $0 
Seat 1: Lorpugo (button) (small blind) folded before Flop
Seat 2: tanata932 (big blind) collected ($0.50)



PokerStars Zoom Hand #236525091899:  Hold'em No Limit ($0.25/$0.50) - 2022/06/02 16:04:54 ET
Table 'C Carinae' 2-max Seat #1 is the button
Seat 1: honeythief11 ($26.57 in chips) 
Seat 2: Lorpugo ($28.79 in chips) 
honeythief11: posts small blind $0.25
Lorpugo: posts big blind $0.50
*** HOLE CARDS ***
Dealt to Lorpugo [9c Kc]
honeythief11: raises $0.75 to $1.25
Lorpugo: calls $0.75
*** FLOP *** [7c 6h 9h]
Lorpugo: checks 
honeythief11: bets $1.31
Lorpugo: raises $26.23 to $27.54 and is all-in
honeythief11: calls $24.01 and is all-in
Uncalled bet ($2.22) returned to Lorpugo
*** TURN *** [7c 6h 9h] [6c]
*** RIVER *** [7c 6h 9h 6c] [Ac]
*** SHOW DOWN ***
Lorpugo: shows [9c Kc] (a flush, Ace high)
honeythief11: shows [3h 7h] (two pair, Sevens and Sixes)
Lorpugo collected $52.39 from pot
*** SUMMARY ***
Total pot $53.14 | Rake $0.75 
Board [7c 6h 9h 6c Ac]
Seat 1: honeythief11 (button) (small blind) showed [3h 7h] and lost with two pair, Sevens and Sixes
Seat 2: Lorpugo (big blind) showed [9c Kc] and won ($52.39) with a flush, Ace high



PokerStars Zoom Hand #236525118567:  Hold'em No Limit ($0.25/$0.50) - 2022/06/02 16:05:43 ET
Table 'C Carinae' 2-max Seat #1 is the button
Seat 1: Lorpugo ($54.61 in chips) 
Seat 2: paddyisthebest ($50 in chips) 
Lorpugo: posts small blind $0.25
paddyisthebest: posts big blind $0.50
*** HOLE CARDS ***
Dealt to Lorpugo [6h 3d]
Lorpugo: folds 
Uncalled bet ($0.25) returned to paddyisthebest
paddyisthebest collected $0.50 from pot
paddyisthebest: doesn't show hand 
*** SUMMARY ***
Total pot $0.50 | Rake $0 
Seat 1: Lorpugo (button) (small blind) folded before Flop
Seat 2: paddyisthebest (big blind) collected ($0.50)



PokerStars Zoom Hand #236525133795:  Hold'em No Limit ($0.25/$0.50) - 2022/06/02 16:06:22 ET
Table 'C Carinae' 2-max Seat #1 is the button
Seat 1: friediii11 ($56.49 in chips) 
Seat 2: Lorpugo ($25 in chips) 
friediii11: posts small blind $0.25
Lorpugo: posts big blind $0.50
*** HOLE CARDS ***
Dealt to Lorpugo [8d Js]
friediii11: raises $0.75 to $1.25
Lorpugo: calls $0.75
*** FLOP *** [Qs 3h 5h]
Lorpugo: bets $0.50
friediii11: raises $2.54 to $3.04
Lorpugo: folds 
Uncalled bet ($2.54) returned to friediii11
friediii11 collected $3.28 from pot
friediii11: doesn't show hand 
*** SUMMARY ***
Total pot $3.50 | Rake $0.22 
Board [Qs 3h 5h]
Seat 1: friediii11 (button) (small blind) collected ($3.28)
Seat 2: Lorpugo (big blind) folded on the Flop



PokerStars Zoom Hand #236525147077:  Hold'em No Limit ($0.25/$0.50) - 2022/06/02 16:06:56 ET
Table 'C Carinae' 2-max Seat #1 is the button
Seat 1: Artagas1 ($109.13 in chips) 
Seat 2: Lorpugo ($23.25 in chips) 
Artagas1: posts small blind $0.25
Lorpugo: posts big blind $0.50
*** HOLE CARDS ***
Dealt to Lorpugo [Ad Ah]
Artagas1: folds 
Uncalled bet ($0.25) returned to Lorpugo
Lorpugo collected $0.50 from pot
Lorpugo: doesn't show hand 
*** SUMMARY ***
Total pot $0.50 | Rake $0 
Seat 1: Artagas1 (button) (small blind) folded before Flop
Seat 2: Lorpugo (big blind) collected ($0.50)



PokerStars Zoom Hand #236525151478:  Hold'em No Limit ($0.25/$0.50) - 2022/06/02 16:07:07 ET
Table 'C Carinae' 2-max Seat #1 is the button
Seat 1: Lorpugo ($23.50 in chips) 
Seat 2: radopan ($54.45 in chips) 
Lorpugo: posts small blind $0.25
radopan: posts big blind $0.50
*** HOLE CARDS ***
Dealt to Lorpugo [8s 4s]
Lorpugo: raises $0.60 to $1.10
radopan: folds 
Uncalled bet ($0.60) returned to Lorpugo
Lorpugo collected $1 from pot
Lorpugo: doesn't show hand 
*** SUMMARY ***
Total pot $1 | Rake $0 
Seat 1: Lorpugo (button) (small blind) collected ($1)
Seat 2: radopan (big blind) folded before Flop



PokerStars Zoom Hand #236525155001:  Hold'em No Limit ($0.25/$0.50) - 2022/06/02 16:07:16 ET
Table 'C Carinae' 2-max Seat #1 is the button
Seat 1: Lorpugo ($24 in chips) 
Seat 2: candonga ($52.14 in chips) 
Lorpugo: posts small blind $0.25
candonga: posts big blind $0.50
*** HOLE CARDS ***
Dealt to Lorpugo [8d 3c]
Lorpugo: folds 
Uncalled bet ($0.25) returned to candonga
candonga collected $0.50 from pot
candonga: doesn't show hand 
*** SUMMARY ***
Total pot $0.50 | Rake $0 
Seat 1: Lorpugo (button) (small blind) folded before Flop
Seat 2: candonga (big blind) collected ($0.50)



PokerStars Zoom Hand #236525158083:  Hold'em No Limit ($0.25/$0.50) - 2022/06/02 16:07:24 ET
Table 'C Carinae' 2-max Seat #1 is the button
Seat 1: MrSuperior ($190.61 in chips) 
Seat 2: Lorpugo ($23.75 in chips) 
MrSuperior: posts small blind $0.25
Lorpugo: posts big blind $0.50
*** HOLE CARDS ***
Dealt to Lorpugo [6c Ts]
MrSuperior: folds 
Uncalled bet ($0.25) returned to Lorpugo
Lorpugo collected $0.50 from pot
Lorpugo: doesn't show hand 
*** SUMMARY ***
Total pot $0.50 | Rake $0 
Seat 1: MrSuperior (button) (small blind) folded before Flop
Seat 2: Lorpugo (big blind) collected ($0.50)



PokerStars Zoom Hand #236525160391:  Hold'em No Limit ($0.25/$0.50) - 2022/06/02 16:07:30 ET
Table 'C Carinae' 2-max Seat #1 is the button
Seat 1: Lorpugo ($24 in chips) 
Seat 2: paddyisthebest ($18.49 in chips) 
Lorpugo: posts small blind $0.25
paddyisthebest: posts big blind $0.50
*** HOLE CARDS ***
Dealt to Lorpugo [8c 9h]
Lorpugo: raises $0.50 to $1
paddyisthebest: raises $17.49 to $18.49 and is all-in
Lorpugo: folds 
Uncalled bet ($17.49) returned to paddyisthebest
paddyisthebest collected $2 from pot
paddyisthebest: doesn't show hand 
*** SUMMARY ***
Total pot $2 | Rake $0 
Seat 1: Lorpugo (button) (small blind) folded before Flop
Seat 2: paddyisthebest (big blind) collected ($2)



PokerStars Zoom Hand #236525164241:  Hold'em No Limit ($0.25/$0.50) - 2022/06/02 16:07:40 ET
Table 'C Carinae' 2-max Seat #1 is the button
Seat 1: idy_hu ($51.08 in chips) 
Seat 2: Lorpugo ($23 in chips) 
idy_hu: posts small blind $0.25
Lorpugo: posts big blind $0.50
*** HOLE CARDS ***
Dealt to Lorpugo [9c Qs]
idy_hu: raises $0.75 to $1.25
Lorpugo: calls $0.75
*** FLOP *** [7h 3d 5d]
Lorpugo: checks 
idy_hu: bets $1.69
Lorpugo: folds 
Uncalled bet ($1.69) returned to idy_hu
idy_hu collected $2.35 from pot
idy_hu: doesn't show hand 
*** SUMMARY ***
Total pot $2.50 | Rake $0.15 
Board [7h 3d 5d]
Seat 1: idy_hu (button) (small blind) collected ($2.35)
Seat 2: Lorpugo (big blind) folded on the Flop



PokerStars Zoom Hand #236525176702:  Hold'em No Limit ($0.25/$0.50) - 2022/06/02 16:08:12 ET
Table 'C Carinae' 2-max Seat #1 is the button
Seat 1: Lorpugo ($21.75 in chips) 
Seat 2: friediii11 ($63.33 in chips) 
Lorpugo: posts small blind $0.25
friediii11: posts big blind $0.50
*** HOLE CARDS ***
Dealt to Lorpugo [Ad Qc]
Lorpugo: raises $0.60 to $1.10
friediii11: folds 
Uncalled bet ($0.60) returned to Lorpugo
Lorpugo collected $1 from pot
Lorpugo: doesn't show hand 
*** SUMMARY ***
Total pot $1 | Rake $0 
Seat 1: Lorpugo (button) (small blind) collected ($1)
Seat 2: friediii11 (big blind) folded before Flop



PokerStars Zoom Hand #236525181396:  Hold'em No Limit ($0.25/$0.50) - 2022/06/02 16:08:24 ET
Table 'C Carinae' 2-max Seat #1 is the button
Seat 1: MrSuperior ($187.36 in chips) 
Seat 2: Lorpugo ($22.25 in chips) 
MrSuperior: posts small blind $0.25
Lorpugo: posts big blind $0.50
*** HOLE CARDS ***
Dealt to Lorpugo [3h 6d]
MrSuperior: calls $0.25
Lorpugo: checks 
*** FLOP *** [4h Kd 2c]
Lorpugo: checks 
MrSuperior: checks 
*** TURN *** [4h Kd 2c] [8s]
Lorpugo: bets $0.55
MrSuperior: folds 
Uncalled bet ($0.55) returned to Lorpugo
Lorpugo collected $0.95 from pot
Lorpugo: doesn't show hand 
*** SUMMARY ***
Total pot $1 | Rake $0.05 
Board [4h Kd 2c 8s]
Seat 1: MrSuperior (button) (small blind) folded on the Turn
Seat 2: Lorpugo (big blind) collected ($0.95)



PokerStars Zoom Hand #236525193368:  Hold'em No Limit ($0.25/$0.50) - 2022/06/02 16:08:55 ET
Table 'C Carinae' 2-max Seat #1 is the button
Seat 1: Artagas1 ($107.93 in chips) 
Seat 2: Lorpugo ($22.70 in chips) 
Artagas1: posts small blind $0.25
Lorpugo: posts big blind $0.50
*** HOLE CARDS ***
Dealt to Lorpugo [8s Kd]
Artagas1: folds 
Uncalled bet ($0.25) returned to Lorpugo
Lorpugo collected $0.50 from pot
Lorpugo: doesn't show hand 
*** SUMMARY ***
Total pot $0.50 | Rake $0 
Seat 1: Artagas1 (button) (small blind) folded before Flop
Seat 2: Lorpugo (big blind) collected ($0.50)



PokerStars Zoom Hand #236525196623:  Hold'em No Limit ($0.25/$0.50) - 2022/06/02 16:09:03 ET
Table 'C Carinae' 2-max Seat #1 is the button
Seat 1: Lorpugo ($22.95 in chips) 
Seat 2: gaz1210 ($25 in chips) 
Lorpugo: posts small blind $0.25
gaz1210: posts big blind $0.50
*** HOLE CARDS ***
Dealt to Lorpugo [As 8s]
Lorpugo: raises $0.60 to $1.10
gaz1210: raises $2.90 to $4
Lorpugo: raises $18.95 to $22.95 and is all-in
gaz1210: calls $18.95
*** FLOP *** [Qs 4d 3h]
*** TURN *** [Qs 4d 3h] [Td]
*** RIVER *** [Qs 4d 3h Td] [Ts]
*** SHOW DOWN ***
gaz1210: shows [Ac 6c] (a pair of Tens)
Lorpugo: shows [As 8s] (a pair of Tens - Ace+Queen+Eight kicker)
Lorpugo collected $45.15 from pot
*** SUMMARY ***
Total pot $45.90 | Rake $0.75 
Board [Qs 4d 3h Td Ts]
Seat 1: Lorpugo (button) (small blind) showed [As 8s] and won ($45.15) with a pair of Tens
Seat 2: gaz1210 (big blind) showed [Ac 6c] and lost with a pair of Tens



PokerStars Zoom Hand #236525208962:  Hold'em No Limit ($0.25/$0.50) - 2022/06/02 16:09:35 ET
Table 'C Carinae' 2-max Seat #1 is the button
Seat 1: Lorpugo ($45.15 in chips) 
Seat 2: idy_hu ($76.53 in chips) 
Lorpugo: posts small blind $0.25
idy_hu: posts big blind $0.50
*** HOLE CARDS ***
Dealt to Lorpugo [9c 8d]
Lorpugo: raises $0.60 to $1.10
idy_hu: folds 
Uncalled bet ($0.60) returned to Lorpugo
Lorpugo collected $1 from pot
Lorpugo: doesn't show hand 
*** SUMMARY ***
Total pot $1 | Rake $0 
Seat 1: Lorpugo (button) (small blind) collected ($1)
Seat 2: idy_hu (big blind) folded before Flop



