PokerStars Zoom Hand #235752211741: Hold'em No Limit ($0.25/$0.50) - 2022/04/26 16:00:10 ET
Table 'C Carinae' 2-max Seat #1 is the button
Seat 1: PrinceViktor ($171.37 in chips)
Seat 2: Lorpugo ($26.79 in chips)
PrinceViktor: posts small blind $0.25
Lorpugo: posts big blind $0.50
*** HOLE CARDS ***
Dealt to Lorpugo [7s 9c]
PrinceViktor: raises $0.75 to $1.25
Lorpugo: calls $0.75
*** FLOP *** [5s 6c 2c]
Lorpugo: checks
PrinceViktor: bets $1.74
Lorpugo: raises $23.80 to $25.54 and is all-in
PrinceViktor: calls $23.80
*** TURN *** [5s 6c 2c] [Jd]
*** RIVER *** [5s 6c 2c Jd] [Qc]
*** SHOW DOWN ***
Lorpugo: shows [7s 9c] (high card Queen)
PrinceViktor: shows [5c Jc] (a flush, Queen high)
PrinceViktor collected $52.64 from pot
*** SUMMARY ***
Total pot $53.58 | Rake $0.94
Board [5s 6c 2c Jd Qc]
Seat 1: PrinceViktor (button) (small blind) showed [5c Jc] and won ($52 .64) with a flush, Queen high
Seat 2: Lorpugo (big blind) showed [7s 9c] and lost with high card Queen


*********** # 2 **************
PokerStars Zoom Hand #235752209560: Hold'em No Limit ($0.25/$0.50) - 2022/04/26 16:00:03 ET
Table 'C Carinae' 2-max Seat #1 is the button
Seat 1: Lorpugo ($27.04 in chips)
Seat 2: iulian3000 ($30 in chips)
Lorpugo: posts small blind $0.25
iulian3000: posts big blind $0.50
*** HOLE CARDS ***
Dealt to Lorpugo [3s 6c]
Lorpugo: folds
Uncalled bet ($0.25) returned to iulian3000
iulian3000 collected $0.50 from pot
iulian3000: doesn't show hand
*** SUMMARY ***
Total pot $0.50 | Rake $0
Seat 1: Lorpugo (button) (small blind) folded before Flop
Seat 2: iulian3000 (big blind) collected ($0.50)


*********** # 3 **************
PokerStars Zoom Hand #235752207144: Hold'em No Limit ($0.25/$0.50) - 2022/04/26 15:59:55 ET
Table 'C Carinae' 2-max Seat #1 is the button
Seat 1: RioRin ($69.71 in chips)
Seat 2: Lorpugo ($27.54 in chips)
RioRin: posts small blind $0.25
Lorpugo: posts big blind $0.50
*** HOLE CARDS ***
Dealt to Lorpugo [5c 3s]
RioRin: raises $1 to $1.50
Lorpugo: folds
Uncalled bet ($1) returned to RioRin
RioRin collected $1 from pot
RioRin: doesn't show hand
*** SUMMARY ***
Total pot $1 | Rake $0
Seat 1: RioRin (button) (small blind) collected ($1)
Seat 2: Lorpugo (big blind) folded before Flop


*********** # 4 **************
PokerStars Zoom Hand #235752154474: Hold'em No Limit ($0.25/$0.50) - 2022/04/26 15:57:04 ET
Table 'C Carinae' 2-max Seat #1 is the button
Seat 1: Lorpugo ($29.23 in chips)
Seat 2: 3bet4win9 ($33.90 in chips)
Lorpugo: posts small blind $0.25
3bet4win9: posts big blind $0.50
*** HOLE CARDS ***
Dealt to Lorpugo [5h 5s]
Lorpugo: raises $0.50 to $1
3bet4win9: raises $1 to $2
Lorpugo: calls $1
*** FLOP *** [2s 9d 3d]
3bet4win9: bets $1.90
Lorpugo: raises $25.33 to $27.23 and is all-in
3bet4win9: calls $25.33
*** TURN *** [2s 9d 3d] [7d]
*** RIVER *** [2s 9d 3d 7d] [6d]
*** SHOW DOWN ***
3bet4win9: shows [Kd Ks] (a flush, King high)
Lorpugo: shows [5h 5s] (a pair of Fives)
3bet4win9 collected $57.71 from pot
*** SUMMARY ***
Total pot $58.46 | Rake $0.75
Board [2s 9d 3d 7d 6d]
Seat 1: Lorpugo (button) (small blind) showed [5h 5s] and lost with a pair of Fives
Seat 2: 3bet4win9 (big blind) showed [Kd Ks] and won ($57.71) with a flush, King high


*********** # 5 **************
PokerStars Zoom Hand #235752152296: Hold'em No Limit ($0.25/$0.50) - 2022/04/26 15:56:56 ET
Table 'C Carinae' 2-max Seat #1 is the button
Seat 1: morozo33 ($50.93 in chips)
Seat 2: Lorpugo ($28.98 in chips)
morozo33: posts small blind $0.25
Lorpugo: posts big blind $0.50
*** HOLE CARDS ***
Dealt to Lorpugo [9c 5d]
morozo33: folds
Uncalled bet ($0.25) returned to Lorpugo
Lorpugo collected $0.50 from pot
Lorpugo: doesn't show hand
*** SUMMARY ***
Total pot $0.50 | Rake $0
Seat 1: morozo33 (button) (small blind) folded before Flop
Seat 2: Lorpugo (big blind) collected ($0.50)


*********** # 6 **************
PokerStars Zoom Hand #235752150524: Hold'em No Limit ($0.25/$0.50) - 2022/04/26 15:56:50 ET
Table 'C Carinae' 2-max Seat #1 is the button
Seat 1: Lorpugo ($29.23 in chips)
Seat 2: TheBluffPL ($51 in chips)
Lorpugo: posts small blind $0.25
TheBluffPL: posts big blind $0.50
*** HOLE CARDS ***
Dealt to Lorpugo [Js 3d]
Lorpugo: folds
Uncalled bet ($0.25) returned to TheBluffPL
TheBluffPL collected $0.50 from pot
TheBluffPL: doesn't show hand
*** SUMMARY ***
Total pot $0.50 | Rake $0
Seat 1: Lorpugo (button) (small blind) folded before Flop
Seat 2: TheBluffPL (big blind) collected ($0.50)


*********** # 7 **************
PokerStars Zoom Hand #235752141307: Hold'em No Limit ($0.25/$0.50) - 2022/04/26 15:56:20 ET
Table 'C Carinae' 2-max Seat #1 is the button
Seat 1: Lorpugo ($26.44 in chips)
Seat 2: numbernine5 ($72.06 in chips)
Lorpugo: posts small blind $0.25
numbernine5: posts big blind $0.50
*** HOLE CARDS ***
Dealt to Lorpugo [6s 4c]
Lorpugo: raises $0.50 to $1
numbernine5: calls $0.50
*** FLOP *** [Qs Qd Kh]
numbernine5: checks
Lorpugo: bets $0.60
numbernine5: calls $0.60
*** TURN *** [Qs Qd Kh] [7s]
numbernine5: checks
Lorpugo: checks
*** RIVER *** [Qs Qd Kh 7s] [4s]
numbernine5: bets $1.50
Lorpugo: calls $1.50
*** SHOW DOWN ***
numbernine5: shows [9c As] (a pair of Queens)
Lorpugo: shows [6s 4c] (two pair, Queens and Fours)
Lorpugo collected $5.89 from pot
*** SUMMARY ***
Total pot $6.20 | Rake $0.31
Board [Qs Qd Kh 7s 4s]
Seat 1: Lorpugo (button) (small blind) showed [6s 4c] and won ($5.89) with two pair, Queens and Fours
Seat 2: numbernine5 (big blind) showed [9c As] and lost with a pair of Queens


*********** # 8 **************
PokerStars Zoom Hand #235752135680: Hold'em No Limit ($0.25/$0.50) - 2022/04/26 15:56:01 ET
Table 'C Carinae' 2-max Seat #1 is the button
Seat 1: Dougpolk27997 ($53.51 in chips)
Seat 2: Lorpugo ($27.69 in chips)
Dougpolk27997: posts small blind $0.25
Lorpugo: posts big blind $0.50
*** HOLE CARDS ***
Dealt to Lorpugo [Tc 3c]
Dougpolk27997: raises $0.75 to $1.25
Lorpugo: calls $0.75
*** FLOP *** [7h Jd 2s]
Lorpugo: checks
Dougpolk27997: bets $0.71
Lorpugo: folds
Uncalled bet ($0.71) returned to Dougpolk27997
Dougpolk27997 collected $2.38 from pot
Dougpolk27997: doesn't show hand
*** SUMMARY ***
Total pot $2.50 | Rake $0.12
Board [7h Jd 2s]
Seat 1: Dougpolk27997 (button) (small blind) collected ($2.38)
Seat 2: Lorpugo (big blind) folded on the Flop


*********** # 9 **************
PokerStars Zoom Hand #235752133041: Hold'em No Limit ($0.25/$0.50) - 2022/04/26 15:55:52 ET
Table 'C Carinae' 2-max Seat #1 is the button
Seat 1: 3bet4win9 ($25.30 in chips)
Seat 2: Lorpugo ($28.19 in chips)
3bet4win9: posts small blind $0.25
Lorpugo: posts big blind $0.50
*** HOLE CARDS ***
Dealt to Lorpugo [4d 6s]
3bet4win9: raises $1 to $1.50
Lorpugo: folds
Uncalled bet ($1) returned to 3bet4win9
3bet4win9 collected $1 from pot
3bet4win9: doesn't show hand
*** SUMMARY ***
Total pot $1 | Rake $0
Seat 1: 3bet4win9 (button) (small blind) collected ($1)
Seat 2: Lorpugo (big blind) folded before Flop


*********** # 10 **************
PokerStars Zoom Hand #235752128836: Hold'em No Limit ($0.25/$0.50) - 2022/04/26 15:55:38 ET
Table 'C Carinae' 2-max Seat #1 is the button
Seat 1: Lorpugo ($27.69 in chips)
Seat 2: PrinceViktor ($133.96 in chips)
Lorpugo: posts small blind $0.25
PrinceViktor: posts big blind $0.50
*** HOLE CARDS ***
Dealt to Lorpugo [7s Ah]
Lorpugo: raises $0.75 to $1.25
PrinceViktor: folds
Uncalled bet ($0.75) returned to Lorpugo
Lorpugo collected $1 from pot
Lorpugo: doesn't show hand
*** SUMMARY ***
Total pot $1 | Rake $0
Seat 1: Lorpugo (button) (small blind) collected ($1)
Seat 2: PrinceViktor (big blind) folded before Flop


*********** # 11 **************
PokerStars Zoom Hand #235752125284: Hold'em No Limit ($0.25/$0.50) - 2022/04/26 15:55:26 ET
Table 'C Carinae' 2-max Seat #1 is the button
Seat 1: PrinceViktor ($133.46 in chips)
Seat 2: Lorpugo ($28.19 in chips)
PrinceViktor: posts small blind $0.25
Lorpugo: posts big blind $0.50
*** HOLE CARDS ***
Dealt to Lorpugo [9c 3h]
PrinceViktor: raises $0.75 to $1.25
Lorpugo: folds
Uncalled bet ($0.75) returned to PrinceViktor
PrinceViktor collected $1 from pot
PrinceViktor: doesn't show hand
*** SUMMARY ***
Total pot $1 | Rake $0
Seat 1: PrinceViktor (button) (small blind) collected ($1)
Seat 2: Lorpugo (big blind) folded before Flop


*********** # 12 **************
PokerStars Zoom Hand #235752119980: Hold'em No Limit ($0.25/$0.50) - 2022/04/26 15:55:10 ET
Table 'C Carinae' 2-max Seat #1 is the button
Seat 1: Lorpugo ($27.29 in chips)
Seat 2: drchilled ($68.24 in chips)
Lorpugo: posts small blind $0.25
drchilled: posts big blind $0.50
*** HOLE CARDS ***
Dealt to Lorpugo [9d 5h]
Lorpugo: raises $0.50 to $1
drchilled: calls $0.50
*** FLOP *** [8d 7c Ad]
drchilled: checks
Lorpugo: bets $0.63
drchilled: folds
Uncalled bet ($0.63) returned to Lorpugo
Lorpugo collected $1.90 from pot
Lorpugo: doesn't show hand
drchilled is disconnected
*** SUMMARY ***
Total pot $2 | Rake $0.10
Board [8d 7c Ad]
Seat 1: Lorpugo (button) (small blind) collected ($1.90)
Seat 2: drchilled (big blind) folded on the Flop


*********** # 13 **************
PokerStars Zoom Hand #235752111609: Hold'em No Limit ($0.25/$0.50) - 2022/04/26 15:54:49 ET
Table 'C Carinae' 2-max Seat #1 is the button
Seat 1: iulian3000 ($49.49 in chips)
Seat 2: Lorpugo ($26.84 in chips)
iulian3000: posts small blind $0.25
Lorpugo: posts big blind $0.50
*** HOLE CARDS ***
Dealt to Lorpugo [2d Jc]
iulian3000: calls $0.25
Lorpugo: checks
*** FLOP *** [Qd Th 4s]
Lorpugo: checks
iulian3000: checks
*** TURN *** [Qd Th 4s] [Ts]
Lorpugo: bets $0.50
iulian3000: folds
Uncalled bet ($0.50) returned to Lorpugo
Lorpugo collected $0.95 from pot
Lorpugo: doesn't show hand
*** SUMMARY ***
Total pot $1 | Rake $0.05
Board [Qd Th 4s Ts]
Seat 1: iulian3000 (button) (small blind) folded on the Turn
Seat 2: Lorpugo (big blind) collected ($0.95)


*********** # 14 **************
PokerStars Zoom Hand #235752103806: Hold'em No Limit ($0.25/$0.50) - 2022/04/26 15:54:29 ET
Table 'C Carinae' 2-max Seat #1 is the button
Seat 1: Lorpugo ($28.84 in chips)
Seat 2: iulian3000 ($47.69 in chips)
Lorpugo: posts small blind $0.25
iulian3000: posts big blind $0.50
*** HOLE CARDS ***
Dealt to Lorpugo [4h 8h]
Lorpugo: raises $0.50 to $1
iulian3000: raises $1 to $2
Lorpugo: calls $1
*** FLOP *** [6c Jd Td]
iulian3000: bets $2
Lorpugo: folds
Uncalled bet ($2) returned to iulian3000
iulian3000 collected $3.80 from pot
iulian3000: doesn't show hand
*** SUMMARY ***
Total pot $4 | Rake $0.20
Board [6c Jd Td]
Seat 1: Lorpugo (button) (small blind) folded on the Flop
Seat 2: iulian3000 (big blind) collected ($3.80)


*********** # 15 **************
PokerStars Zoom Hand #235752100425: Hold'em No Limit ($0.25/$0.50) - 2022/04/26 15:54:21 ET
Table 'C Carinae' 2-max Seat #1 is the button
Seat 1: Dougpolk27997 ($53.25 in chips)
Seat 2: Lorpugo ($29.34 in chips)
Dougpolk27997: posts small blind $0.25
Lorpugo: posts big blind $0.50
*** HOLE CARDS ***
Dealt to Lorpugo [2d Kc]
Dougpolk27997: raises $0.75 to $1.25
Lorpugo: folds
Uncalled bet ($0.75) returned to Dougpolk27997
Dougpolk27997 collected $1 from pot
Dougpolk27997: doesn't show hand
*** SUMMARY ***
Total pot $1 | Rake $0
Seat 1: Dougpolk27997 (button) (small blind) collected ($1)
Seat 2: Lorpugo (big blind) folded before Flop


*********** # 16 **************
PokerStars Zoom Hand #235752095011: Hold'em No Limit ($0.25/$0.50) - 2022/04/26 15:54:07 ET
Table 'C Carinae' 2-max Seat #1 is the button
Seat 1: Lorpugo ($30.34 in chips)
Seat 2: Dougpolk27997 ($52.25 in chips)
Lorpugo: posts small blind $0.25
Dougpolk27997: posts big blind $0.50
*** HOLE CARDS ***
Dealt to Lorpugo [Td 6c]
Lorpugo: raises $0.50 to $1
Dougpolk27997: raises $4 to $5
Lorpugo: folds
Uncalled bet ($4) returned to Dougpolk27997
Dougpolk27997 collected $2 from pot
Dougpolk27997: doesn't show hand
*** SUMMARY ***
Total pot $2 | Rake $0
Seat 1: Lorpugo (button) (small blind) folded before Flop
Seat 2: Dougpolk27997 (big blind) collected ($2)


*********** # 17 **************
PokerStars Zoom Hand #235752080138: Hold'em No Limit ($0.25/$0.50) - 2022/04/26 15:53:29 ET
Table 'C Carinae' 2-max Seat #1 is the button
Seat 1: PrinceViktor ($155.48 in chips)
Seat 2: Lorpugo ($32.38 in chips)
PrinceViktor: posts small blind $0.25
Lorpugo: posts big blind $0.50
*** HOLE CARDS ***
Dealt to Lorpugo [9d Jd]
PrinceViktor: raises $0.75 to $1.25
Lorpugo: calls $0.75
*** FLOP *** [Qc 7h 5d]
Lorpugo: checks
PrinceViktor: bets $0.79
Lorpugo: calls $0.79
*** TURN *** [Qc 7h 5d] [2c]
Lorpugo: checks
PrinceViktor: bets $5.24
Lorpugo: folds
Uncalled bet ($5.24) returned to PrinceViktor
PrinceViktor collected $3.83 from pot
PrinceViktor: doesn't show hand
*** SUMMARY ***
Total pot $4.08 | Rake $0.25
Board [Qc 7h 5d 2c]
Seat 1: PrinceViktor (button) (small blind) collected ($3.83)
Seat 2: Lorpugo (big blind) folded on the Turn


*********** # 18 **************
PokerStars Zoom Hand #235752077032: Hold'em No Limit ($0.25/$0.50) - 2022/04/26 15:53:21 ET
Table 'C Carinae' 2-max Seat #1 is the button
Seat 1: Lorpugo ($31.88 in chips)
Seat 2: morozo33 ($59.53 in chips)
Lorpugo: posts small blind $0.25
morozo33: posts big blind $0.50
*** HOLE CARDS ***
Dealt to Lorpugo [Ks Qs]
Lorpugo: raises $0.75 to $1.25
morozo33: folds
Uncalled bet ($0.75) returned to Lorpugo
Lorpugo collected $1 from pot
Lorpugo: doesn't show hand
*** SUMMARY ***
Total pot $1 | Rake $0
Seat 1: Lorpugo (button) (small blind) collected ($1)
Seat 2: morozo33 (big blind) folded before Flop


*********** # 19 **************
PokerStars Zoom Hand #235752071518: Hold'em No Limit ($0.25/$0.50) - 2022/04/26 15:53:07 ET
Table 'C Carinae' 2-max Seat #1 is the button
Seat 1: Lorpugo ($31.38 in chips)
Seat 2: PrinceViktor ($157.23 in chips)
Lorpugo: posts small blind $0.25
PrinceViktor: posts big blind $0.50
*** HOLE CARDS ***
Dealt to Lorpugo [Kc 5c]
Lorpugo: raises $0.75 to $1.25
PrinceViktor: folds
Uncalled bet ($0.75) returned to Lorpugo
Lorpugo collected $1 from pot
Lorpugo: doesn't show hand
*** SUMMARY ***
Total pot $1 | Rake $0
Seat 1: Lorpugo (button) (small blind) collected ($1)
Seat 2: PrinceViktor (big blind) folded before Flop


*********** # 20 **************
PokerStars Zoom Hand #235752067299: Hold'em No Limit ($0.25/$0.50) - 2022/04/26 15:52:56 ET
Table 'C Carinae' 2-max Seat #1 is the button
Seat 1: PrinceViktor ($156.73 in chips)
Seat 2: Lorpugo ($31.88 in chips)
PrinceViktor: posts small blind $0.25
Lorpugo: posts big blind $0.50
*** HOLE CARDS ***
Dealt to Lorpugo [Td 2h]
PrinceViktor: raises $0.50 to $1
Lorpugo: folds
Uncalled bet ($0.50) returned to PrinceViktor
PrinceViktor collected $1 from pot
PrinceViktor: doesn't show hand
*** SUMMARY ***
Total pot $1 | Rake $0
Seat 1: PrinceViktor (button) (small blind) collected ($1)
Seat 2: Lorpugo (big blind) folded before Flop


*********** # 21 **************
PokerStars Zoom Hand #235752063915: Hold'em No Limit ($0.25/$0.50) - 2022/04/26 15:52:47 ET
Table 'C Carinae' 2-max Seat #1 is the button
Seat 1: ProChris94 ($51.81 in chips)
Seat 2: Lorpugo ($32.38 in chips)
ProChris94: posts small blind $0.25
Lorpugo: posts big blind $0.50
*** HOLE CARDS ***
Dealt to Lorpugo [2s Kc]
ProChris94: raises $1 to $1.50
Lorpugo: folds
Uncalled bet ($1) returned to ProChris94
ProChris94 collected $1 from pot
ProChris94: doesn't show hand
*** SUMMARY ***
Total pot $1 | Rake $0
Seat 1: ProChris94 (button) (small blind) collected ($1)
Seat 2: Lorpugo (big blind) folded before Flop


*********** # 22 **************
PokerStars Zoom Hand #235752053651: Hold'em No Limit ($0.25/$0.50) - 2022/04/26 15:52:21 ET
Table 'C Carinae' 2-max Seat #1 is the button
Seat 1: Lorpugo ($31.25 in chips)
Seat 2: GerryBon ($35.12 in chips)
Lorpugo: posts small blind $0.25
GerryBon: posts big blind $0.50
*** HOLE CARDS ***
Dealt to Lorpugo [9d 7d]
Lorpugo: raises $0.75 to $1.25
GerryBon: calls $0.75
*** FLOP *** [3d 6h Kc]
GerryBon: checks
Lorpugo: bets $0.79
GerryBon: folds
Uncalled bet ($0.79) returned to Lorpugo
Lorpugo collected $2.38 from pot
Lorpugo: doesn't show hand
GerryBon is disconnected
*** SUMMARY ***
Total pot $2.50 | Rake $0.12
Board [3d 6h Kc]
Seat 1: Lorpugo (button) (small blind) collected ($2.38)
Seat 2: GerryBon (big blind) folded on the Flop


*********** # 23 **************
PokerStars Zoom Hand #235752050087: Hold'em No Limit ($0.25/$0.50) - 2022/04/26 15:52:11 ET
Table 'C Carinae' 2-max Seat #1 is the button
Seat 1: Lorpugo ($30.75 in chips)
Seat 2: BRoGeRZ ($54.72 in chips)
Lorpugo: posts small blind $0.25
BRoGeRZ: posts big blind $0.50
*** HOLE CARDS ***
Dealt to Lorpugo [Jh Qd]
Lorpugo: raises $0.75 to $1.25
BRoGeRZ: folds
Uncalled bet ($0.75) returned to Lorpugo
Lorpugo collected $1 from pot
Lorpugo: doesn't show hand
*** SUMMARY ***
Total pot $1 | Rake $0
Seat 1: Lorpugo (button) (small blind) collected ($1)
Seat 2: BRoGeRZ (big blind) folded before Flop


*********** # 24 **************
PokerStars Zoom Hand #235752047268: Hold'em No Limit ($0.25/$0.50) - 2022/04/26 15:52:04 ET
Table 'C Carinae' 2-max Seat #1 is the button
Seat 1: .TilTandWiN. ($86.73 in chips)
Seat 2: Lorpugo ($31.25 in chips)
.TilTandWiN.: posts small blind $0.25
Lorpugo: posts big blind $0.50
*** HOLE CARDS ***
Dealt to Lorpugo [Ts 2h]
.TilTandWiN.: raises $0.60 to $1.10
Lorpugo: folds
Uncalled bet ($0.60) returned to .TilTandWiN.
.TilTandWiN. collected $1 from pot
.TilTandWiN.: doesn't show hand
*** SUMMARY ***
Total pot $1 | Rake $0
Seat 1: .TilTandWiN. (button) (small blind) collected ($1)
Seat 2: Lorpugo (big blind) folded before Flop


*********** # 25 **************
PokerStars Zoom Hand #235752040143: Hold'em No Limit ($0.25/$0.50) - 2022/04/26 15:51:46 ET
Table 'C Carinae' 2-max Seat #1 is the button
Seat 1: iulian3000 ($37.32 in chips)
Seat 2: Lorpugo ($30.80 in chips)
iulian3000: posts small blind $0.25
Lorpugo: posts big blind $0.50
*** HOLE CARDS ***
Dealt to Lorpugo [3s 7s]
iulian3000: calls $0.25
Lorpugo: checks
*** FLOP *** [4h Qh 3d]
Lorpugo: bets $0.50
iulian3000: folds
Uncalled bet ($0.50) returned to Lorpugo
Lorpugo collected $0.95 from pot
Lorpugo: doesn't show hand
*** SUMMARY ***
Total pot $1 | Rake $0.05
Board [4h Qh 3d]
Seat 1: iulian3000 (button) (small blind) folded on the Flop
Seat 2: Lorpugo (big blind) collected ($0.95)


*********** # 26 **************
PokerStars Zoom Hand #235752027633: Hold'em No Limit ($0.25/$0.50) - 2022/04/26 15:51:14 ET
Table 'C Carinae' 2-max Seat #1 is the button
Seat 1: iulian3000 ($27.43 in chips)
Seat 2: Lorpugo ($41.44 in chips)
iulian3000: posts small blind $0.25
Lorpugo: posts big blind $0.50
*** HOLE CARDS ***
Dealt to Lorpugo [Jd Kh]
iulian3000: calls $0.25
Lorpugo: raises $1.25 to $1.75
iulian3000: calls $1.25
*** FLOP *** [5d 2d 8c]
Lorpugo: bets $1.10
iulian3000: calls $1.10
*** TURN *** [5d 2d 8c] [2h]
Lorpugo: bets $1.79
iulian3000: calls $1.79
*** RIVER *** [5d 2d 8c 2h] [Qc]
Lorpugo: bets $6
iulian3000: calls $6
*** SHOW DOWN ***
Lorpugo: shows [Jd Kh] (a pair of Deuces)
iulian3000: shows [9c 8s] (two pair, Eights and Deuces)
iulian3000 collected $20.53 from pot
*** SUMMARY ***
Total pot $21.28 | Rake $0.75
Board [5d 2d 8c 2h Qc]
Seat 1: iulian3000 (button) (small blind) showed [9c 8s] and won ($20.53) with two pair, Eights and Deuces
Seat 2: Lorpugo (big blind) showed [Jd Kh] and lost with a pair of Deuces


*********** # 27 **************
PokerStars Zoom Hand #235752025436: Hold'em No Limit ($0.25/$0.50) - 2022/04/26 15:51:08 ET
Table 'C Carinae' 2-max Seat #1 is the button
Seat 1: Lorpugo ($41.69 in chips)
Seat 2: GerryBon ($34.87 in chips)
Lorpugo: posts small blind $0.25
GerryBon: posts big blind $0.50
*** HOLE CARDS ***
Dealt to Lorpugo [6s Jc]
Lorpugo: folds
Uncalled bet ($0.25) returned to GerryBon
GerryBon collected $0.50 from pot
GerryBon: doesn't show hand
*** SUMMARY ***
Total pot $0.50 | Rake $0
Seat 1: Lorpugo (button) (small blind) folded before Flop
Seat 2: GerryBon (big blind) collected ($0.50)


*********** # 28 **************
PokerStars Zoom Hand #235752021415: Hold'em No Limit ($0.25/$0.50) - 2022/04/26 15:50:58 ET
Table 'C Carinae' 2-max Seat #1 is the button
Seat 1: Lorpugo ($41.94 in chips)
Seat 2: scirocco994 ($105.31 in chips)
Lorpugo: posts small blind $0.25
scirocco994: posts big blind $0.50
*** HOLE CARDS ***
Dealt to Lorpugo [2s Qc]
Lorpugo: folds
Uncalled bet ($0.25) returned to scirocco994
scirocco994 collected $0.50 from pot
scirocco994: doesn't show hand
*** SUMMARY ***
Total pot $0.50 | Rake $0
Seat 1: Lorpugo (button) (small blind) folded before Flop
Seat 2: scirocco994 (big blind) collected ($0.50)


*********** # 29 **************
PokerStars Zoom Hand #235752014342: Hold'em No Limit ($0.25/$0.50) - 2022/04/26 15:50:50 ET
Table 'C Carinae' 2-max Seat #1 is the button
Seat 1: numbernine5 ($51.25 in chips)
Seat 2: Lorpugo ($41.69 in chips)
numbernine5: posts small blind $0.25
Lorpugo: posts big blind $0.50
*** HOLE CARDS ***
Dealt to Lorpugo [5c 9s]
numbernine5: folds
Uncalled bet ($0.25) returned to Lorpugo
Lorpugo collected $0.50 from pot
Lorpugo: doesn't show hand
*** SUMMARY ***
Total pot $0.50 | Rake $0
Seat 1: numbernine5 (button) (small blind) folded before Flop
Seat 2: Lorpugo (big blind) collected ($0.50)


*********** # 30 **************
PokerStars Zoom Hand #235751923904: Hold'em No Limit ($0.25/$0.50) - 2022/04/26 15:46:54 ET
Table 'C Carinae' 2-max Seat #1 is the button
Seat 1: PrinceViktor ($74.41 in chips)
Seat 2: Lorpugo ($32.70 in chips)
PrinceViktor: posts small blind $0.25
Lorpugo: posts big blind $0.50
*** HOLE CARDS ***
Dealt to Lorpugo [Kd Qh]
PrinceViktor: raises $0.75 to $1.25
Lorpugo: raises $2.75 to $4
PrinceViktor: calls $2.75
*** FLOP *** [Td Jc 4d]
Lorpugo: bets $3.80
PrinceViktor: calls $3.80
*** TURN *** [Td Jc 4d] [Qd]
Lorpugo: bets $9
PrinceViktor: raises $44.35 to $53.35
Lorpugo: calls $15.90 and is all-in
Uncalled bet ($28.45) returned to PrinceViktor
*** RIVER *** [Td Jc 4d Qd] [2d]
*** SHOW DOWN ***
Lorpugo: shows [Kd Qh] (a flush, King high)
PrinceViktor: shows [9s Ad] (a flush, Ace high)
PrinceViktor collected $64.46 from pot
*** SUMMARY ***
Total pot $65.40 | Rake $0.94
Board [Td Jc 4d Qd 2d]
Seat 1: PrinceViktor (button) (small blind) showed [9s Ad] and won ($64 .46) with a flush, Ace high
Seat 2: Lorpugo (big blind) showed [Kd Qh] and lost with a flush, King high


*********** # 31 **************
PokerStars Zoom Hand #235751920825: Hold'em No Limit ($0.25/$0.50) - 2022/04/26 15:46:46 ET
Table 'C Carinae' 2-max Seat #1 is the button
Seat 1: Lorpugo ($32.20 in chips)
Seat 2: iulian3000 ($39.15 in chips)
Lorpugo: posts small blind $0.25
iulian3000: posts big blind $0.50
*** HOLE CARDS ***
Dealt to Lorpugo [9c Qh]
Lorpugo: raises $0.75 to $1.25
iulian3000: folds
Uncalled bet ($0.75) returned to Lorpugo
Lorpugo collected $1 from pot
Lorpugo: doesn't show hand
*** SUMMARY ***
Total pot $1 | Rake $0
Seat 1: Lorpugo (button) (small blind) collected ($1)
Seat 2: iulian3000 (big blind) folded before Flop


*********** # 32 **************
PokerStars Zoom Hand #235751905728: Hold'em No Limit ($0.25/$0.50) - 2022/04/26 15:46:07 ET
Table 'C Carinae' 2-max Seat #1 is the button
Seat 1: PrinceViktor ($93.01 in chips)
Seat 2: Lorpugo ($27.03 in chips)
PrinceViktor: posts small blind $0.25
Lorpugo: posts big blind $0.50
*** HOLE CARDS ***
Dealt to Lorpugo [Qd Ac]
PrinceViktor: raises $0.75 to $1.25
Lorpugo: raises $2.50 to $3.75
PrinceViktor: calls $2.50
*** FLOP *** [Kh Jh 4c]
Lorpugo: checks
PrinceViktor: checks
*** TURN *** [Kh Jh 4c] [4s]
Lorpugo: bets $2
PrinceViktor: calls $2
*** RIVER *** [Kh Jh 4c 4s] [As]
Lorpugo: bets $5.46
PrinceViktor: folds
Uncalled bet ($5.46) returned to Lorpugo
Lorpugo collected $10.92 from pot
Lorpugo: doesn't show hand
*** SUMMARY ***
Total pot $11.50 | Rake $0.58
Board [Kh Jh 4c 4s As]
Seat 1: PrinceViktor (button) (small blind) folded on the River
Seat 2: Lorpugo (big blind) collected ($10.92)


*********** # 33 **************
PokerStars Zoom Hand #235751901972: Hold'em No Limit ($0.25/$0.50) - 2022/04/26 15:45:57 ET
Table 'C Carinae' 2-max Seat #1 is the button
Seat 1: TheBluffPL ($50 in chips)
Seat 2: Lorpugo ($25.78 in chips)
TheBluffPL: posts small blind $0.25
Lorpugo: posts big blind $0.50
*** HOLE CARDS ***
Dealt to Lorpugo [9h Ah]
TheBluffPL: raises $0.75 to $1.25
Lorpugo: raises $2.50 to $3.75
TheBluffPL: folds
Uncalled bet ($2.50) returned to Lorpugo
Lorpugo collected $2.50 from pot
Lorpugo: doesn't show hand
*** SUMMARY ***
Total pot $2.50 | Rake $0
Seat 1: TheBluffPL (button) (small blind) folded before Flop
Seat 2: Lorpugo (big blind) collected ($2.50)


*********** # 34 **************
PokerStars Zoom Hand #235751898153: Hold'em No Limit ($0.25/$0.50) - 2022/04/26 15:45:47 ET
Table 'C Carinae' 2-max Seat #1 is the button
Seat 1: Lorpugo ($25.28 in chips)
Seat 2: drchilled ($55.70 in chips)
Lorpugo: posts small blind $0.25
drchilled: posts big blind $0.50
*** HOLE CARDS ***
Dealt to Lorpugo [3d 6d]
Lorpugo: raises $0.50 to $1
drchilled: folds
Uncalled bet ($0.50) returned to Lorpugo
Lorpugo collected $1 from pot
Lorpugo: doesn't show hand
drchilled is disconnected
*** SUMMARY ***
Total pot $1 | Rake $0
Seat 1: Lorpugo (button) (small blind) collected ($1)
Seat 2: drchilled (big blind) folded before Flop


*********** # 35 **************
PokerStars Zoom Hand #235751891020: Hold'em No Limit ($0.25/$0.50) - 2022/04/26 15:45:28 ET
Table 'C Carinae' 2-max Seat #1 is the button
Seat 1: Lorpugo ($24.38 in chips)
Seat 2: numbernine5 ($55.98 in chips)
Lorpugo: posts small blind $0.25
numbernine5: posts big blind $0.50
*** HOLE CARDS ***
Dealt to Lorpugo [Qh 6s]
Lorpugo: raises $0.50 to $1
numbernine5: calls $0.50
*** FLOP *** [Js Jc 2c]
numbernine5: checks
Lorpugo: checks
*** TURN *** [Js Jc 2c] [7d]
numbernine5: checks
Lorpugo: bets $0.50
numbernine5: folds
Uncalled bet ($0.50) returned to Lorpugo
Lorpugo collected $1.90 from pot
Lorpugo: doesn't show hand
*** SUMMARY ***
Total pot $2 | Rake $0.10
Board [Js Jc 2c 7d]
Seat 1: Lorpugo (button) (small blind) collected ($1.90)
Seat 2: numbernine5 (big blind) folded on the Turn


*********** # 36 **************
PokerStars Zoom Hand #235751871945: Hold'em No Limit ($0.25/$0.50) - 2022/04/26 15:44:56 ET
Table 'C Carinae' 2-max Seat #1 is the button
Seat 1: karakoK10 ($41.07 in chips)
Seat 2: Lorpugo ($20.78 in chips)
karakoK10: posts small blind $0.25
Lorpugo: posts big blind $0.50
*** HOLE CARDS ***
Dealt to Lorpugo [Ac 8c]
karakoK10: raises $0.75 to $1.25
Lorpugo: raises $2.75 to $4
karakoK10: calls $2.75
*** FLOP *** [3c 4s Ad]
Lorpugo: checks
karakoK10: checks
*** TURN *** [3c 4s Ad] [2h]
Lorpugo: checks
karakoK10: checks
*** RIVER *** [3c 4s Ad 2h] [As]
Lorpugo: checks
karakoK10: checks
*** SHOW DOWN ***
Lorpugo: shows [Ac 8c] (three of a kind, Aces)
karakoK10: mucks hand
Lorpugo collected $7.60 from pot
*** SUMMARY ***
Total pot $8 | Rake $0.40
Board [3c 4s Ad 2h As]
Seat 1: karakoK10 (button) (small blind) mucked [Tc Kc]
Seat 2: Lorpugo (big blind) showed [Ac 8c] and won ($7.60) with three of a kind, Aces


*********** # 37 **************
PokerStars Zoom Hand #235751859429: Hold'em No Limit ($0.25/$0.50) - 2022/04/26 15:44:23 ET
Table 'C Carinae' 2-max Seat #1 is the button
Seat 1: Lorpugo ($19.65 in chips)
Seat 2: PrinceViktor ($73.81 in chips)
Lorpugo: posts small blind $0.25
PrinceViktor: posts big blind $0.50
*** HOLE CARDS ***
Dealt to Lorpugo [8d 9c]
Lorpugo: raises $0.75 to $1.25
PrinceViktor: calls $0.75
*** FLOP *** [2h Ks Qs]
PrinceViktor: checks
Lorpugo: bets $0.75
PrinceViktor: folds
Uncalled bet ($0.75) returned to Lorpugo
Lorpugo collected $2.38 from pot
Lorpugo: doesn't show hand
*** SUMMARY ***
Total pot $2.50 | Rake $0.12
Board [2h Ks Qs]
Seat 1: Lorpugo (button) (small blind) collected ($2.38)
Seat 2: PrinceViktor (big blind) folded on the Flop


*********** # 38 **************
PokerStars Zoom Hand #235751856833: Hold'em No Limit ($0.25/$0.50) - 2022/04/26 15:44:16 ET
Table 'C Carinae' 2-max Seat #1 is the button
Seat 1: ZenMisery ($50 in chips)
Seat 2: Lorpugo ($20.15 in chips)
ZenMisery: posts small blind $0.25
Lorpugo: posts big blind $0.50
*** HOLE CARDS ***
Dealt to Lorpugo [9d 3c]
ZenMisery: raises $0.75 to $1.25
Lorpugo: folds
Uncalled bet ($0.75) returned to ZenMisery
ZenMisery collected $1 from pot
ZenMisery: doesn't show hand
*** SUMMARY ***
Total pot $1 | Rake $0
Seat 1: ZenMisery (button) (small blind) collected ($1)
Seat 2: Lorpugo (big blind) folded before Flop


*********** # 39 **************
PokerStars Zoom Hand #235751854863: Hold'em No Limit ($0.25/$0.50) - 2022/04/26 15:44:11 ET
Table 'C Carinae' 2-max Seat #1 is the button
Seat 1: Lorpugo ($20.40 in chips)
Seat 2: scirocco994 ($119.22 in chips)
Lorpugo: posts small blind $0.25
scirocco994: posts big blind $0.50
*** HOLE CARDS ***
Dealt to Lorpugo [3d 4h]
Lorpugo: folds
Uncalled bet ($0.25) returned to scirocco994
scirocco994 collected $0.50 from pot
scirocco994: doesn't show hand
*** SUMMARY ***
Total pot $0.50 | Rake $0
Seat 1: Lorpugo (button) (small blind) folded before Flop
Seat 2: scirocco994 (big blind) collected ($0.50)


*********** # 40 **************
PokerStars Zoom Hand #235751845749: Hold'em No Limit ($0.25/$0.50) - 2022/04/26 15:43:47 ET
Table 'C Carinae' 2-max Seat #1 is the button
Seat 1: scirocco994 ($121.35 in chips)
Seat 2: Lorpugo ($18.48 in chips)
scirocco994: posts small blind $0.25
Lorpugo: posts big blind $0.50
*** HOLE CARDS ***
Dealt to Lorpugo [3s Ah]
scirocco994: raises $0.50 to $1
Lorpugo: calls $0.50
*** FLOP *** [3c 4s 6s]
Lorpugo: checks
scirocco994: checks
*** TURN *** [3c 4s 6s] [Td]
Lorpugo: bets $0.63
scirocco994: calls $0.63
*** RIVER *** [3c 4s 6s Td] [Kd]
Lorpugo: bets $0.50
scirocco994: calls $0.50
*** SHOW DOWN ***
Lorpugo: shows [3s Ah] (a pair of Threes)
scirocco994: mucks hand
Lorpugo collected $4.05 from pot
*** SUMMARY ***
Total pot $4.26 | Rake $0.21
Board [3c 4s 6s Td Kd]
Seat 1: scirocco994 (button) (small blind) mucked [Js 8h]
Seat 2: Lorpugo (big blind) showed [3s Ah] and won ($4.05) with a pair of Threes


*********** # 41 **************
PokerStars Zoom Hand #235751836475: Hold'em No Limit ($0.25/$0.50) - 2022/04/26 15:43:23 ET
Table 'C Carinae' 2-max Seat #1 is the button
Seat 1: Lorpugo ($17.35 in chips)
Seat 2: E N L 22 ($50 in chips)
Lorpugo: posts small blind $0.25
E N L 22: posts big blind $0.50
*** HOLE CARDS ***
Dealt to Lorpugo [Qd 5d]
Lorpugo: raises $0.75 to $1.25
E N L 22: calls $0.75
*** FLOP *** [6h Ad Ts]
E N L 22: checks
Lorpugo: bets $0.79
E N L 22: folds
Uncalled bet ($0.79) returned to Lorpugo
Lorpugo collected $2.38 from pot
Lorpugo: doesn't show hand
E N L 22 is disconnected
*** SUMMARY ***
Total pot $2.50 | Rake $0.12
Board [6h Ad Ts]
Seat 1: Lorpugo (button) (small blind) collected ($2.38)
Seat 2: E N L 22 (big blind) folded on the Flop


*********** # 42 **************
PokerStars Zoom Hand #235751823283: Hold'em No Limit ($0.25/$0.50) - 2022/04/26 15:42:49 ET
Table 'C Carinae' 2-max Seat #1 is the button
Seat 1: Ares656 ($63.51 in chips)
Seat 2: Lorpugo ($19.10 in chips)
Ares656: posts small blind $0.25
Lorpugo: posts big blind $0.50
*** HOLE CARDS ***
Dealt to Lorpugo [7c 8d]
Ares656: raises $0.50 to $1
Lorpugo: calls $0.50
*** FLOP *** [Jc Qd Ts]
Lorpugo: checks
Ares656: checks
*** TURN *** [Jc Qd Ts] [Ad]
Lorpugo: bets $0.75
Ares656: calls $0.75
*** RIVER *** [Jc Qd Ts Ad] [3c]
Lorpugo: checks
Ares656: bets $4.98
Lorpugo: folds
Uncalled bet ($4.98) returned to Ares656
Ares656 collected $3.32 from pot
Ares656: doesn't show hand
*** SUMMARY ***
Total pot $3.50 | Rake $0.18
Board [Jc Qd Ts Ad 3c]
Seat 1: Ares656 (button) (small blind) collected ($3.32)
Seat 2: Lorpugo (big blind) folded on the River


*********** # 43 **************
PokerStars Zoom Hand #235751816050: Hold'em No Limit ($0.25/$0.50) - 2022/04/26 15:42:29 ET
Table 'C Carinae' 2-max Seat #1 is the button
Seat 1: Lorpugo ($17.97 in chips)
Seat 2: BRoGeRZ ($71.50 in chips)
Lorpugo: posts small blind $0.25
BRoGeRZ: posts big blind $0.50
*** HOLE CARDS ***
Dealt to Lorpugo [Ah 4c]
Lorpugo: raises $0.75 to $1.25
BRoGeRZ: calls $0.75
*** FLOP *** [Ts Jc Td]
BRoGeRZ: checks
Lorpugo: checks
*** TURN *** [Ts Jc Td] [6c]
BRoGeRZ: checks
Lorpugo: bets $0.79
BRoGeRZ: folds
Uncalled bet ($0.79) returned to Lorpugo
Lorpugo collected $2.38 from pot
Lorpugo: doesn't show hand
*** SUMMARY ***
Total pot $2.50 | Rake $0.12
Board [Ts Jc Td 6c]
Seat 1: Lorpugo (button) (small blind) collected ($2.38)
Seat 2: BRoGeRZ (big blind) folded on the Turn


*********** # 44 **************
PokerStars Zoom Hand #235751808488: Hold'em No Limit ($0.25/$0.50) - 2022/04/26 15:42:09 ET
Table 'C Carinae' 2-max Seat #1 is the button
Seat 1: TheBluffPL ($58.09 in chips)
Seat 2: Lorpugo ($16.72 in chips)
TheBluffPL: posts small blind $0.25
Lorpugo: posts big blind $0.50
*** HOLE CARDS ***
Dealt to Lorpugo [Ad 5s]
TheBluffPL: raises $0.75 to $1.25
Lorpugo: raises $2.75 to $4
TheBluffPL: folds
Uncalled bet ($2.75) returned to Lorpugo
Lorpugo collected $2.50 from pot
Lorpugo: doesn't show hand
*** SUMMARY ***
Total pot $2.50 | Rake $0
Seat 1: TheBluffPL (button) (small blind) folded before Flop
Seat 2: Lorpugo (big blind) collected ($2.50)


*********** # 45 **************
PokerStars Zoom Hand #235751799136: Hold'em No Limit ($0.25/$0.50) - 2022/04/26 15:41:45 ET
Table 'C Carinae' 2-max Seat #1 is the button
Seat 1: Lorpugo ($18.59 in chips)
Seat 2: Ares656 ($61.83 in chips)
Lorpugo: posts small blind $0.25
Ares656: posts big blind $0.50
*** HOLE CARDS ***
Dealt to Lorpugo [Qs 6h]
Lorpugo: raises $0.65 to $1.15
Ares656: calls $0.65
*** FLOP *** [7c Jd 6s]
Ares656: checks
Lorpugo: bets $0.72
Ares656: raises $2.78 to $3.50
Lorpugo: folds
Uncalled bet ($2.78) returned to Ares656
Ares656 collected $3.55 from pot
Ares656: doesn't show hand
*** SUMMARY ***
Total pot $3.74 | Rake $0.19
Board [7c Jd 6s]
Seat 1: Lorpugo (button) (small blind) folded on the Flop
Seat 2: Ares656 (big blind) collected ($3.55)


*********** # 46 **************
PokerStars Zoom Hand #235751792238: Hold'em No Limit ($0.25/$0.50) - 2022/04/26 15:41:27 ET
Table 'C Carinae' 2-max Seat #1 is the button
Seat 1: Ares656 ($62.98 in chips)
Seat 2: Lorpugo ($17.44 in chips)
Ares656: posts small blind $0.25
Lorpugo: posts big blind $0.50
*** HOLE CARDS ***
Dealt to Lorpugo [Qs Ac]
Ares656: raises $0.65 to $1.15
Lorpugo: raises $2.60 to $3.75
Ares656: folds
Uncalled bet ($2.60) returned to Lorpugo
Lorpugo collected $2.30 from pot
Lorpugo: doesn't show hand
*** SUMMARY ***
Total pot $2.30 | Rake $0
Seat 1: Ares656 (button) (small blind) folded before Flop
Seat 2: Lorpugo (big blind) collected ($2.30)


*********** # 47 **************
PokerStars Zoom Hand #235751788826: Hold'em No Limit ($0.25/$0.50) - 2022/04/26 15:41:18 ET
Table 'C Carinae' 2-max Seat #1 is the button
Seat 1: Lorpugo ($16.94 in chips)
Seat 2: scirocco994 ($130.65 in chips)
Lorpugo: posts small blind $0.25
scirocco994: posts big blind $0.50
*** HOLE CARDS ***
Dealt to Lorpugo [7c 5c]
Lorpugo: raises $0.75 to $1.25
scirocco994: folds
Uncalled bet ($0.75) returned to Lorpugo
Lorpugo collected $1 from pot
Lorpugo: doesn't show hand
*** SUMMARY ***
Total pot $1 | Rake $0
Seat 1: Lorpugo (button) (small blind) collected ($1)
Seat 2: scirocco994 (big blind) folded before Flop


*********** # 48 **************
PokerStars Zoom Hand #235751786239: Hold'em No Limit ($0.25/$0.50) - 2022/04/26 15:41:11 ET
Table 'C Carinae' 2-max Seat #1 is the button
Seat 1: xRhythm ($50.65 in chips)
Seat 2: Lorpugo ($16.69 in chips)
xRhythm: posts small blind $0.25
Lorpugo: posts big blind $0.50
*** HOLE CARDS ***
Dealt to Lorpugo [As 7d]
xRhythm: folds
Uncalled bet ($0.25) returned to Lorpugo
Lorpugo collected $0.50 from pot
Lorpugo: doesn't show hand
*** SUMMARY ***
Total pot $0.50 | Rake $0
Seat 1: xRhythm (button) (small blind) folded before Flop
Seat 2: Lorpugo (big blind) collected ($0.50)


*********** # 49 **************
PokerStars Zoom Hand #235751781586: Hold'em No Limit ($0.25/$0.50) - 2022/04/26 15:40:59 ET
Table 'C Carinae' 2-max Seat #1 is the button
Seat 1: Lorpugo ($16.19 in chips)
Seat 2: xRhythm ($51.15 in chips)
Lorpugo: posts small blind $0.25
xRhythm: posts big blind $0.50
*** HOLE CARDS ***
Dealt to Lorpugo [Ac 8h]
Lorpugo: raises $0.75 to $1.25
xRhythm: folds
Uncalled bet ($0.75) returned to Lorpugo
Lorpugo collected $1 from pot
Lorpugo: doesn't show hand
*** SUMMARY ***
Total pot $1 | Rake $0
Seat 1: Lorpugo (button) (small blind) collected ($1)
Seat 2: xRhythm (big blind) folded before Flop


*********** # 50 **************
PokerStars Zoom Hand #235751776779: Hold'em No Limit ($0.25/$0.50) - 2022/04/26 15:40:47 ET
Table 'C Carinae' 2-max Seat #1 is the button
Seat 1: PrinceViktor ($50.50 in chips)
Seat 2: Lorpugo ($16.69 in chips)
PrinceViktor: posts small blind $0.25
Lorpugo: posts big blind $0.50
*** HOLE CARDS ***
Dealt to Lorpugo [Kh 2c]
PrinceViktor: raises $0.75 to $1.25
Lorpugo: folds
Uncalled bet ($0.75) returned to PrinceViktor
PrinceViktor collected $1 from pot
PrinceViktor: doesn't show hand
*** SUMMARY ***
Total pot $1 | Rake $0
Seat 1: PrinceViktor (button) (small blind) collected ($1)
Seat 2: Lorpugo (big blind) folded before Flop


*********** # 51 **************
PokerStars Zoom Hand #235751774916: Hold'em No Limit ($0.25/$0.50) - 2022/04/26 15:40:42 ET
Table 'C Carinae' 2-max Seat #1 is the button
Seat 1: Lorpugo ($16.94 in chips)
Seat 2: I kill U 84 ($66.02 in chips)
Lorpugo: posts small blind $0.25
I kill U 84: posts big blind $0.50
*** HOLE CARDS ***
Dealt to Lorpugo [3h 4s]
Lorpugo: folds
Uncalled bet ($0.25) returned to I kill U 84
I kill U 84 collected $0.50 from pot
I kill U 84: doesn't show hand
*** SUMMARY ***
Total pot $0.50 | Rake $0
Seat 1: Lorpugo (button) (small blind) folded before Flop
Seat 2: I kill U 84 (big blind) collected ($0.50)


*********** # 52 **************
PokerStars Zoom Hand #235751772232: Hold'em No Limit ($0.25/$0.50) - 2022/04/26 15:40:35 ET
Table 'C Carinae' 2-max Seat #1 is the button
Seat 1: BRoGeRZ ($19.40 in chips)
Seat 2: Lorpugo ($16.69 in chips)
BRoGeRZ: posts small blind $0.25
Lorpugo: posts big blind $0.50
*** HOLE CARDS ***
Dealt to Lorpugo [4d Ac]
BRoGeRZ: folds
Uncalled bet ($0.25) returned to Lorpugo
Lorpugo collected $0.50 from pot
Lorpugo: doesn't show hand
*** SUMMARY ***
Total pot $0.50 | Rake $0
Seat 1: BRoGeRZ (button) (small blind) folded before Flop
Seat 2: Lorpugo (big blind) collected ($0.50)


*********** # 53 **************
PokerStars Zoom Hand #235751762828: Hold'em No Limit ($0.25/$0.50) - 2022/04/26 15:40:10 ET
Table 'C Carinae' 2-max Seat #1 is the button
Seat 1: Lorpugo ($17.94 in chips)
Seat 2: EkimM1978 ($42.51 in chips)
Lorpugo: posts small blind $0.25
EkimM1978: posts big blind $0.50
*** HOLE CARDS ***
Dealt to Lorpugo [Th 7s]
Lorpugo: raises $0.75 to $1.25
EkimM1978: calls $0.75
*** FLOP *** [6h Jd 5h]
EkimM1978: checks
Lorpugo: checks
*** TURN *** [6h Jd 5h] [2s]
EkimM1978: checks
Lorpugo: checks
*** RIVER *** [6h Jd 5h 2s] [Js]
EkimM1978: checks
Lorpugo: checks
*** SHOW DOWN ***
EkimM1978: shows [Tc 9s] (a pair of Jacks)
Lorpugo: mucks hand
EkimM1978 collected $2.35 from pot
*** SUMMARY ***
Total pot $2.50 | Rake $0.15
Board [6h Jd 5h 2s Js]
Seat 1: Lorpugo (button) (small blind) mucked [Th 7s]
Seat 2: EkimM1978 (big blind) showed [Tc 9s] and won ($2.35) with a pair of Jacks


*********** # 54 **************
PokerStars Zoom Hand #235751760091: Hold'em No Limit ($0.25/$0.50) - 2022/04/26 15:40:03 ET
Table 'C Carinae' 2-max Seat #1 is the button
Seat 1: I kill U 84 ($65.27 in chips)
Seat 2: Lorpugo ($17.69 in chips)
I kill U 84: posts small blind $0.25
Lorpugo: posts big blind $0.50
*** HOLE CARDS ***
Dealt to Lorpugo [9h 3s]
I kill U 84: folds
Uncalled bet ($0.25) returned to Lorpugo
Lorpugo collected $0.50 from pot
Lorpugo: doesn't show hand
*** SUMMARY ***
Total pot $0.50 | Rake $0
Seat 1: I kill U 84 (button) (small blind) folded before Flop
Seat 2: Lorpugo (big blind) collected ($0.50)


*********** # 55 **************
PokerStars Zoom Hand #235751745347: Hold'em No Limit ($0.25/$0.50) - 2022/04/26 15:39:24 ET
Table 'C Carinae' 2-max Seat #1 is the button
Seat 1: Lorpugo ($20.86 in chips)
Seat 2: I kill U 84 ($62.50 in chips)
Lorpugo: posts small blind $0.25
I kill U 84: posts big blind $0.50
*** HOLE CARDS ***
Dealt to Lorpugo [9d 2d]
Lorpugo: raises $0.50 to $1
I kill U 84: calls $0.50
*** FLOP *** [6d 7h 6c]
I kill U 84: checks
Lorpugo: bets $0.95
I kill U 84: calls $0.95
*** TURN *** [6d 7h 6c] [2c]
I kill U 84: checks
Lorpugo: bets $1.22
I kill U 84: calls $1.22
*** RIVER *** [6d 7h 6c 2c] [8s]
I kill U 84: checks
Lorpugo: checks
*** SHOW DOWN ***
I kill U 84: shows [2s Ad] (two pair, Sixes and Deuces)
Lorpugo: mucks hand
I kill U 84 collected $5.94 from pot
*** SUMMARY ***
Total pot $6.34 | Rake $0.40
Board [6d 7h 6c 2c 8s]
Seat 1: Lorpugo (button) (small blind) mucked [9d 2d]
Seat 2: I kill U 84 (big blind) showed [2s Ad] and won ($5.94) with two pair, Sixes and Deuces


*********** # 56 **************
PokerStars Zoom Hand #235751737855: Hold'em No Limit ($0.25/$0.50) - 2022/04/26 15:39:09 ET
Table 'C Carinae' 2-max Seat #1 is the button
Seat 1: PrinceViktor ($76.83 in chips)
Seat 2: Lorpugo ($21.36 in chips)
PrinceViktor: posts small blind $0.25
Lorpugo: posts big blind $0.50
*** HOLE CARDS ***
Dealt to Lorpugo [4c 5h]
PrinceViktor: raises $0.75 to $1.25
Lorpugo: folds
Uncalled bet ($0.75) returned to PrinceViktor
PrinceViktor collected $1 from pot
PrinceViktor: doesn't show hand
*** SUMMARY ***
Total pot $1 | Rake $0
Seat 1: PrinceViktor (button) (small blind) collected ($1)
Seat 2: Lorpugo (big blind) folded before Flop


*********** # 57 **************
PokerStars Zoom Hand #235751734146: Hold'em No Limit ($0.25/$0.50) - 2022/04/26 15:38:59 ET
Table 'C Carinae' 2-max Seat #1 is the button
Seat 1: Lorpugo ($21.61 in chips)
Seat 2: numbernine5 ($59.29 in chips)
Lorpugo: posts small blind $0.25
numbernine5: posts big blind $0.50
*** HOLE CARDS ***
Dealt to Lorpugo [8d 2s]
Lorpugo: folds
Uncalled bet ($0.25) returned to numbernine5
numbernine5 collected $0.50 from pot
numbernine5: doesn't show hand
*** SUMMARY ***
Total pot $0.50 | Rake $0
Seat 1: Lorpugo (button) (small blind) folded before Flop
Seat 2: numbernine5 (big blind) collected ($0.50)


*********** # 58 **************
PokerStars Zoom Hand #235751726833: Hold'em No Limit ($0.25/$0.50) - 2022/04/26 15:38:40 ET
Table 'C Carinae' 2-max Seat #1 is the button
Seat 1: PrinceViktor ($55.92 in chips)
Seat 2: Lorpugo ($20.36 in chips)
PrinceViktor: posts small blind $0.25
Lorpugo: posts big blind $0.50
*** HOLE CARDS ***
Dealt to Lorpugo [Ts Ah]
PrinceViktor: raises $0.75 to $1.25
Lorpugo: raises $2.75 to $4
PrinceViktor: folds
Uncalled bet ($2.75) returned to Lorpugo
Lorpugo collected $2.50 from pot
Lorpugo: doesn't show hand
*** SUMMARY ***
Total pot $2.50 | Rake $0
Seat 1: PrinceViktor (button) (small blind) folded before Flop
Seat 2: Lorpugo (big blind) collected ($2.50)


*********** # 59 **************
PokerStars Zoom Hand #235751718889: Hold'em No Limit ($0.25/$0.50) - 2022/04/26 15:38:19 ET
Table 'C Carinae' 2-max Seat #1 is the button
Seat 1: Lorpugo ($21.61 in chips)
Seat 2: iulian3000 ($73.43 in chips)
Lorpugo: posts small blind $0.25
iulian3000: posts big blind $0.50
*** HOLE CARDS ***
Dealt to Lorpugo [7c 8c]
Lorpugo: raises $0.75 to $1.25
iulian3000: calls $0.75
*** FLOP *** [Kc Qs 4s]
iulian3000: bets $1
Lorpugo: folds
Uncalled bet ($1) returned to iulian3000
iulian3000 collected $2.38 from pot
iulian3000: doesn't show hand
*** SUMMARY ***
Total pot $2.50 | Rake $0.12
Board [Kc Qs 4s]
Seat 1: Lorpugo (button) (small blind) folded on the Flop
Seat 2: iulian3000 (big blind) collected ($2.38)


*********** # 60 **************
PokerStars Zoom Hand #235751709299: Hold'em No Limit ($0.25/$0.50) - 2022/04/26 15:37:54 ET
Table 'C Carinae' 2-max Seat #1 is the button
Seat 1: karakoK10 ($40.87 in chips)
Seat 2: Lorpugo ($22.61 in chips)
karakoK10: posts small blind $0.25
Lorpugo: posts big blind $0.50
*** HOLE CARDS ***
Dealt to Lorpugo [Ks 3d]
karakoK10: calls $0.25
Lorpugo: checks
*** FLOP *** [Qc Qh 4d]
Lorpugo: checks
karakoK10: checks
*** TURN *** [Qc Qh 4d] [Jc]
Lorpugo: bets $0.50
karakoK10: calls $0.50
*** RIVER *** [Qc Qh 4d Jc] [8c]
Lorpugo: checks
karakoK10: bets $0.50
Lorpugo: folds
Uncalled bet ($0.50) returned to karakoK10
karakoK10 collected $1.90 from pot
karakoK10: doesn't show hand
*** SUMMARY ***
Total pot $2 | Rake $0.10
Board [Qc Qh 4d Jc 8c]
Seat 1: karakoK10 (button) (small blind) collected ($1.90)
Seat 2: Lorpugo (big blind) folded on the River


*********** # 61 **************
PokerStars Zoom Hand #235751692579: Hold'em No Limit ($0.25/$0.50) - 2022/04/26 15:37:10 ET
Table 'C Carinae' 2-max Seat #1 is the button
Seat 1: Lorpugo ($22.71 in chips)
Seat 2: PrinceViktor ($54.75 in chips)
Lorpugo: posts small blind $0.25
PrinceViktor: posts big blind $0.50
*** HOLE CARDS ***
Dealt to Lorpugo [3h Ah]
Lorpugo: raises $0.75 to $1.25
PrinceViktor: calls $0.75
*** FLOP *** [2d Ts 5s]
PrinceViktor: checks
Lorpugo: bets $0.79
PrinceViktor: calls $0.79
*** TURN *** [2d Ts 5s] [6h]
PrinceViktor: checks
Lorpugo: checks
*** RIVER *** [2d Ts 5s 6h] [9c]
PrinceViktor: checks
Lorpugo: checks
*** SHOW DOWN ***
PrinceViktor: shows [3d As] (high card Ace)
Lorpugo: shows [3h Ah] (high card Ace)
PrinceViktor collected $1.92 from pot
Lorpugo collected $1.94 from pot
*** SUMMARY ***
Total pot $4.08 | Rake $0.22
Board [2d Ts 5s 6h 9c]
Seat 1: Lorpugo (button) (small blind) showed [3h Ah] and won ($1.94) with high card Ace
Seat 2: PrinceViktor (big blind) showed [3d As] and won ($1.92) with high card Ace


*********** # 62 **************
PokerStars Zoom Hand #235751680688: Hold'em No Limit ($0.25/$0.50) - 2022/04/26 15:36:39 ET
Table 'C Carinae' 2-max Seat #1 is the button
Seat 1: PrinceViktor ($50.75 in chips)
Seat 2: Lorpugo ($26.71 in chips)
PrinceViktor: posts small blind $0.25
Lorpugo: posts big blind $0.50
*** HOLE CARDS ***
Dealt to Lorpugo [5s Ad]
PrinceViktor: raises $0.75 to $1.25
Lorpugo: raises $2.75 to $4
PrinceViktor: raises $46.75 to $50.75 and is all-in
Lorpugo: folds
Uncalled bet ($46.75) returned to PrinceViktor
PrinceViktor collected $8 from pot
PrinceViktor: doesn't show hand
*** SUMMARY ***
Total pot $8 | Rake $0
Seat 1: PrinceViktor (button) (small blind) collected ($8)
Seat 2: Lorpugo (big blind) folded before Flop


*********** # 63 **************
PokerStars Zoom Hand #235751676559: Hold'em No Limit ($0.25/$0.50) - 2022/04/26 15:36:28 ET
Table 'C Carinae' 2-max Seat #1 is the button
Seat 1: Lorpugo ($26.21 in chips)
Seat 2: xRhythm ($51.15 in chips)
Lorpugo: posts small blind $0.25
xRhythm: posts big blind $0.50
*** HOLE CARDS ***
Dealt to Lorpugo [Ks 7d]
Lorpugo: raises $0.75 to $1.25
xRhythm: folds
Uncalled bet ($0.75) returned to Lorpugo
Lorpugo collected $1 from pot
Lorpugo: doesn't show hand
*** SUMMARY ***
Total pot $1 | Rake $0
Seat 1: Lorpugo (button) (small blind) collected ($1)
Seat 2: xRhythm (big blind) folded before Flop


*********** # 64 **************
PokerStars Zoom Hand #235751664020: Hold'em No Limit ($0.25/$0.50) - 2022/04/26 15:35:55 ET
Table 'C Carinae' 2-max Seat #1 is the button
Seat 1: Lorpugo ($25.08 in chips)
Seat 2: guillermo324 ($46.59 in chips)
Lorpugo: posts small blind $0.25
guillermo324: posts big blind $0.50
*** HOLE CARDS ***
Dealt to Lorpugo [8d 8c]
Lorpugo: raises $0.75 to $1.25
guillermo324: calls $0.75
*** FLOP *** [Jd Td 2h]
guillermo324: checks
Lorpugo: checks
*** TURN *** [Jd Td 2h] [Th]
guillermo324: checks
Lorpugo: bets $1.45
guillermo324: folds
Uncalled bet ($1.45) returned to Lorpugo
Lorpugo collected $2.38 from pot
Lorpugo: doesn't show hand
guillermo324 is disconnected
*** SUMMARY ***
Total pot $2.50 | Rake $0.12
Board [Jd Td 2h Th]
Seat 1: Lorpugo (button) (small blind) collected ($2.38)
Seat 2: guillermo324 (big blind) folded on the Turn


*********** # 65 **************
PokerStars Zoom Hand #235751651729: Hold'em No Limit ($0.25/$0.50) - 2022/04/26 15:35:23 ET
Table 'C Carinae' 2-max Seat #1 is the button
Seat 1: PrinceViktor ($81.04 in chips)
Seat 2: Lorpugo ($26.33 in chips)
PrinceViktor: posts small blind $0.25
Lorpugo: posts big blind $0.50
*** HOLE CARDS ***
Dealt to Lorpugo [7h 8s]
PrinceViktor: raises $0.75 to $1.25
Lorpugo: calls $0.75
*** FLOP *** [8d Ks Qd]
Lorpugo: checks
PrinceViktor: bets $0.79
Lorpugo: folds
Uncalled bet ($0.79) returned to PrinceViktor
PrinceViktor collected $2.35 from pot
PrinceViktor: doesn't show hand
*** SUMMARY ***
Total pot $2.50 | Rake $0.15
Board [8d Ks Qd]
Seat 1: PrinceViktor (button) (small blind) collected ($2.35)
Seat 2: Lorpugo (big blind) folded on the Flop


*********** # 66 **************
PokerStars Zoom Hand #235751632020: Hold'em No Limit ($0.25/$0.50) - 2022/04/26 15:34:30 ET
Table 'C Carinae' 2-max Seat #1 is the button
Seat 1: iulian3000 ($35.56 in chips)
Seat 2: Lorpugo ($26.55 in chips)
iulian3000: posts small blind $0.25
Lorpugo: posts big blind $0.50
*** HOLE CARDS ***
Dealt to Lorpugo [4s 6c]
iulian3000: calls $0.25
Lorpugo: checks
*** FLOP *** [5d 5h 4d]
Lorpugo: checks
iulian3000: bets $1.50
Lorpugo: calls $1.50
*** TURN *** [5d 5h 4d] [Qs]
Lorpugo: checks
iulian3000: bets $2.50
Lorpugo: calls $2.50
*** RIVER *** [5d 5h 4d Qs] [3d]
Lorpugo: checks
iulian3000: checks
*** SHOW DOWN ***
Lorpugo: shows [4s 6c] (two pair, Fives and Fours)
iulian3000: shows [4h 3h] (two pair, Fives and Fours)
Lorpugo collected $4.28 from pot
iulian3000 collected $4.27 from pot
*** SUMMARY ***
Total pot $9 | Rake $0.45
Board [5d 5h 4d Qs 3d]
Seat 1: iulian3000 (button) (small blind) showed [4h 3h] and won ($4.27) with two pair, Fives and Fours
Seat 2: Lorpugo (big blind) showed [4s 6c] and won ($4.28) with two pair, Fives and Fours


*********** # 67 **************
PokerStars Zoom Hand #235751605067: Hold'em No Limit ($0.25/$0.50) - 2022/04/26 15:33:20 ET
Table 'C Carinae' 2-max Seat #1 is the button
Seat 1: Lorpugo ($33.34 in chips)
Seat 2: TheBluffPL ($108.81 in chips)
Lorpugo: posts small blind $0.25
TheBluffPL: posts big blind $0.50
*** HOLE CARDS ***
Dealt to Lorpugo [7s Ac]
Lorpugo: raises $0.75 to $1.25
TheBluffPL: calls $0.75
*** FLOP *** [Jc 5s 9c]
TheBluffPL: checks
Lorpugo: checks
*** TURN *** [Jc 5s 9c] [7c]
TheBluffPL: bets $1.55
Lorpugo: calls $1.55
*** RIVER *** [Jc 5s 9c 7c] [7h]
TheBluffPL: bets $3.99
Lorpugo: calls $3.99
*** SHOW DOWN ***
TheBluffPL: shows [8c Qc] (a flush, Queen high)
Lorpugo: mucks hand
TheBluffPL collected $12.90 from pot
*** SUMMARY ***
Total pot $13.58 | Rake $0.68
Board [Jc 5s 9c 7c 7h]
Seat 1: Lorpugo (button) (small blind) mucked [7s Ac]
Seat 2: TheBluffPL (big blind) showed [8c Qc] and won ($12.90) with a flush, Queen high


*********** # 68 **************
PokerStars Zoom Hand #235751601611: Hold'em No Limit ($0.25/$0.50) - 2022/04/26 15:33:11 ET
Table 'C Carinae' 2-max Seat #1 is the button
Seat 1: Lorpugo ($33.59 in chips)
Seat 2: numbernine5 ($52.13 in chips)
Lorpugo: posts small blind $0.25
numbernine5: posts big blind $0.50
*** HOLE CARDS ***
Dealt to Lorpugo [3h 2s]
Lorpugo: folds
Uncalled bet ($0.25) returned to numbernine5
numbernine5 collected $0.50 from pot
numbernine5: doesn't show hand
*** SUMMARY ***
Total pot $0.50 | Rake $0
Seat 1: Lorpugo (button) (small blind) folded before Flop
Seat 2: numbernine5 (big blind) collected ($0.50)


*********** # 69 **************
PokerStars Zoom Hand #235751595304: Hold'em No Limit ($0.25/$0.50) - 2022/04/26 15:32:55 ET
Table 'C Carinae' 2-max Seat #1 is the button
Seat 1: PrinceViktor ($69.51 in chips)
Seat 2: Lorpugo ($34.09 in chips)
PrinceViktor: posts small blind $0.25
Lorpugo: posts big blind $0.50
*** HOLE CARDS ***
Dealt to Lorpugo [2c 3h]
PrinceViktor: raises $0.75 to $1.25
Lorpugo: folds
Uncalled bet ($0.75) returned to PrinceViktor
PrinceViktor collected $1 from pot
PrinceViktor: doesn't show hand
*** SUMMARY ***
Total pot $1 | Rake $0
Seat 1: PrinceViktor (button) (small blind) collected ($1)
Seat 2: Lorpugo (big blind) folded before Flop


*********** # 70 **************
PokerStars Zoom Hand #235751578300: Hold'em No Limit ($0.25/$0.50) - 2022/04/26 15:32:11 ET
Table 'C Carinae' 2-max Seat #1 is the button
Seat 1: Lorpugo ($36.14 in chips)
Seat 2: PrinceViktor ($67.71 in chips)
Lorpugo: posts small blind $0.25
PrinceViktor: posts big blind $0.50
*** HOLE CARDS ***
Dealt to Lorpugo [2s 4s]
Lorpugo: raises $0.50 to $1
PrinceViktor: calls $0.50
*** FLOP *** [Ts 3d Kc]
PrinceViktor: checks
Lorpugo: checks
*** TURN *** [Ts 3d Kc] [5d]
PrinceViktor: checks
Lorpugo: bets $1.05
PrinceViktor: calls $1.05
*** RIVER *** [Ts 3d Kc 5d] [8c]
PrinceViktor: checks
Lorpugo: checks
*** SHOW DOWN ***
PrinceViktor: shows [Tc 6s] (a pair of Tens)
Lorpugo: mucks hand
PrinceViktor collected $3.85 from pot
*** SUMMARY ***
Total pot $4.10 | Rake $0.25
Board [Ts 3d Kc 5d 8c]
Seat 1: Lorpugo (button) (small blind) mucked [2s 4s]
Seat 2: PrinceViktor (big blind) showed [Tc 6s] and won ($3.85) with a pair of Tens


*********** # 71 **************
PokerStars Zoom Hand #235751567144: Hold'em No Limit ($0.25/$0.50) - 2022/04/26 15:31:42 ET
Table 'C Carinae' 2-max Seat #1 is the button
Seat 1: karakoK10 ($42.30 in chips)
Seat 2: Lorpugo ($37.64 in chips)
karakoK10: posts small blind $0.25
Lorpugo: posts big blind $0.50
*** HOLE CARDS ***
Dealt to Lorpugo [6h Kc]
karakoK10: raises $0.50 to $1
Lorpugo: calls $0.50
*** FLOP *** [4c Jd 7h]
Lorpugo: bets $0.50
karakoK10: raises $2.47 to $2.97
Lorpugo: folds
Uncalled bet ($2.47) returned to karakoK10
karakoK10 collected $2.85 from pot
karakoK10: doesn't show hand
*** SUMMARY ***
Total pot $3 | Rake $0.15
Board [4c Jd 7h]
Seat 1: karakoK10 (button) (small blind) collected ($2.85)
Seat 2: Lorpugo (big blind) folded on the Flop


*********** # 72 **************
PokerStars Zoom Hand #235751540614: Hold'em No Limit ($0.25/$0.50) - 2022/04/26 15:30:34 ET
Table 'C Carinae' 2-max Seat #1 is the button
Seat 1: E N L 22 ($13.89 in chips)
Seat 2: Lorpugo ($24.50 in chips)
E N L 22: posts small blind $0.25
Lorpugo: posts big blind $0.50
*** HOLE CARDS ***
Dealt to Lorpugo [Qs 4d]
E N L 22: calls $0.25
Lorpugo: checks
*** FLOP *** [9d Qc 3c]
Lorpugo: checks
E N L 22: bets $0.95
Lorpugo: calls $0.95
*** TURN *** [9d Qc 3c] [Ts]
Lorpugo: checks
E N L 22: bets $2.76
Lorpugo: calls $2.76
*** RIVER *** [9d Qc 3c Ts] [5c]
Lorpugo: checks
E N L 22: bets $9.68 and is all-in
Lorpugo: calls $9.68
*** SHOW DOWN ***
E N L 22: shows [3d Kc] (a pair of Threes)
Lorpugo: shows [Qs 4d] (a pair of Queens)
Lorpugo collected $27.03 from pot
*** SUMMARY ***
Total pot $27.78 | Rake $0.75
Board [9d Qc 3c Ts 5c]
Seat 1: E N L 22 (button) (small blind) showed [3d Kc] and lost with a pair of Threes
Seat 2: Lorpugo (big blind) showed [Qs 4d] and won ($27.03) with a pair of Queens


*********** # 73 **************
PokerStars Zoom Hand #235751531068: Hold'em No Limit ($0.25/$0.50) - 2022/04/26 15:30:09 ET
Table 'C Carinae' 2-max Seat #1 is the button
Seat 1: Lorpugo ($23.37 in chips)
Seat 2: Ares656 ($50 in chips)
Lorpugo: posts small blind $0.25
Ares656: posts big blind $0.50
*** HOLE CARDS ***
Dealt to Lorpugo [Js 7d]
Lorpugo: raises $0.75 to $1.25
Ares656: calls $0.75
*** FLOP *** [5c Ad Jd]
Ares656: checks
Lorpugo: bets $0.79
Ares656: folds
Uncalled bet ($0.79) returned to Lorpugo
Lorpugo collected $2.38 from pot
Lorpugo: doesn't show hand
*** SUMMARY ***
Total pot $2.50 | Rake $0.12
Board [5c Ad Jd]
Seat 1: Lorpugo (button) (small blind) collected ($2.38)
Seat 2: Ares656 (big blind) folded on the Flop


*********** # 74 **************
PokerStars Zoom Hand #235751521208: Hold'em No Limit ($0.25/$0.50) - 2022/04/26 15:29:43 ET
Table 'C Carinae' 2-max Seat #1 is the button
Seat 1: MeryjanePL ($52.98 in chips)
Seat 2: Lorpugo ($19.32 in chips)
MeryjanePL: posts small blind $0.25
Lorpugo: posts big blind $0.50
*** HOLE CARDS ***
Dealt to Lorpugo [4d 7d]
MeryjanePL: raises $1 to $1.50
Lorpugo: raises $3 to $4.50
MeryjanePL: calls $3
*** FLOP *** [Kh 8d 6s]
Lorpugo: bets $14.82 and is all-in
MeryjanePL: folds
Uncalled bet ($14.82) returned to Lorpugo
Lorpugo collected $8.55 from pot
Lorpugo: doesn't show hand
*** SUMMARY ***
Total pot $9 | Rake $0.45
Board [Kh 8d 6s]
Seat 1: MeryjanePL (button) (small blind) folded on the Flop
Seat 2: Lorpugo (big blind) collected ($8.55)


*********** # 75 **************
PokerStars Zoom Hand #235751516250: Hold'em No Limit ($0.25/$0.50) - 2022/04/26 15:29:30 ET
Table 'C Carinae' 2-max Seat #1 is the button
Seat 1: Lorpugo ($18.82 in chips)
Seat 2: luirian_1989 ($26.06 in chips)
Lorpugo: posts small blind $0.25
luirian_1989: posts big blind $0.50
*** HOLE CARDS ***
Dealt to Lorpugo [6c Qh]
Lorpugo: raises $0.75 to $1.25
luirian_1989: folds
Uncalled bet ($0.75) returned to Lorpugo
Lorpugo collected $1 from pot
Lorpugo: doesn't show hand
*** SUMMARY ***
Total pot $1 | Rake $0
Seat 1: Lorpugo (button) (small blind) collected ($1)
Seat 2: luirian_1989 (big blind) folded before Flop


*********** # 76 **************
PokerStars Zoom Hand #235751513878: Hold'em No Limit ($0.25/$0.50) - 2022/04/26 15:29:23 ET
Table 'C Carinae' 2-max Seat #1 is the button
Seat 1: ExtasyGanja ($65.37 in chips)
Seat 2: Lorpugo ($18.57 in chips)
ExtasyGanja: posts small blind $0.25
Lorpugo: posts big blind $0.50
*** HOLE CARDS ***
Dealt to Lorpugo [8s Ac]
ExtasyGanja: folds
Uncalled bet ($0.25) returned to Lorpugo
Lorpugo collected $0.50 from pot
Lorpugo: doesn't show hand
*** SUMMARY ***
Total pot $0.50 | Rake $0
Seat 1: ExtasyGanja (button) (small blind) folded before Flop
Seat 2: Lorpugo (big blind) collected ($0.50)


*********** # 77 **************
PokerStars Zoom Hand #235751505782: Hold'em No Limit ($0.25/$0.50) - 2022/04/26 15:29:02 ET
Table 'C Carinae' 2-max Seat #1 is the button
Seat 1: Lorpugo ($18.07 in chips)
Seat 2: TheBluffPL ($106.96 in chips)
Lorpugo: posts small blind $0.25
TheBluffPL: posts big blind $0.50
*** HOLE CARDS ***
Dealt to Lorpugo [9d Th]
Lorpugo: raises $0.75 to $1.25
TheBluffPL: folds
Uncalled bet ($0.75) returned to Lorpugo
Lorpugo collected $1 from pot
Lorpugo: doesn't show hand
*** SUMMARY ***
Total pot $1 | Rake $0
Seat 1: Lorpugo (button) (small blind) collected ($1)
Seat 2: TheBluffPL (big blind) folded before Flop


*********** # 78 **************
PokerStars Zoom Hand #235751496944: Hold'em No Limit ($0.25/$0.50) - 2022/04/26 15:28:39 ET
Table 'C Carinae' 2-max Seat #1 is the button
Seat 1: TheBluffPL ($108.21 in chips)
Seat 2: Lorpugo ($16.82 in chips)
TheBluffPL: posts small blind $0.25
Lorpugo: posts big blind $0.50
*** HOLE CARDS ***
Dealt to Lorpugo [9c 7c]
TheBluffPL: raises $0.75 to $1.25
Lorpugo: raises $2.75 to $4
TheBluffPL: folds
Uncalled bet ($2.75) returned to Lorpugo
Lorpugo collected $2.50 from pot
Lorpugo: doesn't show hand
*** SUMMARY ***
Total pot $2.50 | Rake $0
Seat 1: TheBluffPL (button) (small blind) folded before Flop
Seat 2: Lorpugo (big blind) collected ($2.50)


*********** # 79 **************
PokerStars Zoom Hand #235751492702: Hold'em No Limit ($0.25/$0.50) - 2022/04/26 15:28:28 ET
Table 'C Carinae' 2-max Seat #1 is the button
Seat 1: Lorpugo ($16.32 in chips)
Seat 2: PrinceViktor ($71.95 in chips)
Lorpugo: posts small blind $0.25
PrinceViktor: posts big blind $0.50
*** HOLE CARDS ***
Dealt to Lorpugo [5c 7c]
Lorpugo: raises $0.75 to $1.25
PrinceViktor: folds
Uncalled bet ($0.75) returned to Lorpugo
Lorpugo collected $1 from pot
Lorpugo: doesn't show hand
*** SUMMARY ***
Total pot $1 | Rake $0
Seat 1: Lorpugo (button) (small blind) collected ($1)
Seat 2: PrinceViktor (big blind) folded before Flop


*********** # 80 **************
PokerStars Zoom Hand #235751484348: Hold'em No Limit ($0.25/$0.50) - 2022/04/26 15:28:06 ET
Table 'C Carinae' 2-max Seat #1 is the button
Seat 1: xRhythm ($66.54 in chips)
Seat 2: Lorpugo ($15.07 in chips)
xRhythm: posts small blind $0.25
Lorpugo: posts big blind $0.50
*** HOLE CARDS ***
Dealt to Lorpugo [8h Ad]
xRhythm: raises $0.75 to $1.25
Lorpugo: raises $2.50 to $3.75
xRhythm: folds
Uncalled bet ($2.50) returned to Lorpugo
Lorpugo collected $2.50 from pot
Lorpugo: doesn't show hand
*** SUMMARY ***
Total pot $2.50 | Rake $0
Seat 1: xRhythm (button) (small blind) folded before Flop
Seat 2: Lorpugo (big blind) collected ($2.50)


*********** # 81 **************
PokerStars Zoom Hand #235751457526: Hold'em No Limit ($0.25/$0.50) - 2022/04/26 15:26:55 ET
Table 'C Carinae' 2-max Seat #1 is the button
Seat 1: Lorpugo ($26 in chips)
Seat 2: E N L 22 ($58.92 in chips)
Lorpugo: posts small blind $0.25
E N L 22: posts big blind $0.50
*** HOLE CARDS ***
Dealt to Lorpugo [Qs 4d]
Lorpugo: raises $0.50 to $1
E N L 22: calls $0.50
*** FLOP *** [5s 3s 7d]
E N L 22: checks
Lorpugo: bets $0.90
E N L 22: calls $0.90
*** TURN *** [5s 3s 7d] [9d]
E N L 22: checks
Lorpugo: checks
*** RIVER *** [5s 3s 7d 9d] [Ah]
E N L 22: bets $3.61
Lorpugo: raises $5.42 to $9.03
E N L 22: raises $47.99 to $57.02 and is all-in
Lorpugo: folds
Uncalled bet ($47.99) returned to E N L 22
E N L 22 collected $20.92 from pot
E N L 22: doesn't show hand
*** SUMMARY ***
Total pot $21.86 | Rake $0.94
Board [5s 3s 7d 9d Ah]
Seat 1: Lorpugo (button) (small blind) folded on the River
Seat 2: E N L 22 (big blind) collected ($20.92)


*********** # 82 **************
PokerStars Zoom Hand #235751455308: Hold'em No Limit ($0.25/$0.50) - 2022/04/26 15:26:49 ET
Table 'C Carinae' 2-max Seat #1 is the button
Seat 1: karakoK10 ($54.33 in chips)
Seat 2: Lorpugo ($25.75 in chips)
karakoK10: posts small blind $0.25
Lorpugo: posts big blind $0.50
*** HOLE CARDS ***
Dealt to Lorpugo [Kh 6c]
karakoK10: folds
Uncalled bet ($0.25) returned to Lorpugo
Lorpugo collected $0.50 from pot
Lorpugo: doesn't show hand
*** SUMMARY ***
Total pot $0.50 | Rake $0
Seat 1: karakoK10 (button) (small blind) folded before Flop
Seat 2: Lorpugo (big blind) collected ($0.50)


*********** # 83 **************
PokerStars Zoom Hand #235751451055: Hold'em No Limit ($0.25/$0.50) - 2022/04/26 15:26:38 ET
Table 'C Carinae' 2-max Seat #1 is the button
Seat 1: Lorpugo ($25.25 in chips)
Seat 2: karakoK10 ($54.83 in chips)
Lorpugo: posts small blind $0.25
karakoK10: posts big blind $0.50
*** HOLE CARDS ***
Dealt to Lorpugo [Js Th]
Lorpugo: raises $0.60 to $1.10
karakoK10: folds
Uncalled bet ($0.60) returned to Lorpugo
Lorpugo collected $1 from pot
Lorpugo: doesn't show hand
*** SUMMARY ***
Total pot $1 | Rake $0
Seat 1: Lorpugo (button) (small blind) collected ($1)
Seat 2: karakoK10 (big blind) folded before Flop


*********** # 84 **************
PokerStars Zoom Hand #235751447762: Hold'em No Limit ($0.25/$0.50) - 2022/04/26 15:26:29 ET
Table 'C Carinae' 2-max Seat #1 is the button
Seat 1: luirian_1989 ($25.63 in chips)
Seat 2: Lorpugo ($25 in chips)
luirian_1989: posts small blind $0.25
Lorpugo: posts big blind $0.50
*** HOLE CARDS ***
Dealt to Lorpugo [7s 3h]
luirian_1989: folds
Uncalled bet ($0.25) returned to Lorpugo
Lorpugo collected $0.50 from pot
Lorpugo: doesn't show hand
*** SUMMARY ***
Total pot $0.50 | Rake $0
Seat 1: luirian_1989 (button) (small blind) folded before Flop
Seat 2: Lorpugo (big blind) collected ($0.50)


*********** # 85 **************
PokerStars Zoom Hand #235751378460: Hold'em No Limit ($0.25/$0.50) - 2022/04/26 15:23:40 ET
Table 'C Carinae' 2-max Seat #1 is the button
Seat 1: Lorpugo ($21.08 in chips)
Seat 2: Ares656 ($53.20 in chips)
Lorpugo: posts small blind $0.25
Ares656: posts big blind $0.50
*** HOLE CARDS ***
Dealt to Lorpugo [3s Qd]
Lorpugo: raises $0.50 to $1
Ares656: calls $0.50
*** FLOP *** [6h 5s 9h]
Ares656: checks
Lorpugo: checks
*** TURN *** [6h 5s 9h] [Js]
Ares656: checks
Lorpugo: checks
*** RIVER *** [6h 5s 9h Js] [3c]
Ares656: checks
Lorpugo: checks
*** SHOW DOWN ***
Ares656: shows [8s 5c] (a pair of Fives)
Lorpugo: mucks hand
Ares656 collected $1.90 from pot
*** SUMMARY ***
Total pot $2 | Rake $0.10
Board [6h 5s 9h Js 3c]
Seat 1: Lorpugo (button) (small blind) mucked [3s Qd]
Seat 2: Ares656 (big blind) showed [8s 5c] and won ($1.90) with a pair of Fives


*********** # 86 **************
PokerStars Zoom Hand #235751353067: Hold'em No Limit ($0.25/$0.50) - 2022/04/26 15:22:35 ET
Table 'C Carinae' 2-max Seat #1 is the button
Seat 1: Lorpugo ($28.12 in chips)
Seat 2: worldethos ($97.05 in chips)
Lorpugo: posts small blind $0.25
worldethos: posts big blind $0.50
*** HOLE CARDS ***
Dealt to Lorpugo [Js 9s]
Lorpugo: raises $0.60 to $1.10
worldethos: raises $2.90 to $4
Lorpugo: calls $2.90
*** FLOP *** [6h 3h 2c]
worldethos: bets $3.04
Lorpugo: calls $3.04
*** TURN *** [6h 3h 2c] [3c]
worldethos: bets $8.83
Lorpugo: folds
Uncalled bet ($8.83) returned to worldethos
worldethos collected $13.20 from pot
worldethos: doesn't show hand
*** SUMMARY ***
Total pot $14.08 | Rake $0.88
Board [6h 3h 2c 3c]
Seat 1: Lorpugo (button) (small blind) folded on the Turn
Seat 2: worldethos (big blind) collected ($13.20)


*********** # 87 **************
PokerStars Zoom Hand #235751346464: Hold'em No Limit ($0.25/$0.50) - 2022/04/26 15:22:18 ET
Table 'C Carinae' 2-max Seat #1 is the button
Seat 1: worldethos ($96.55 in chips)
Seat 2: Lorpugo ($28.62 in chips)
worldethos: posts small blind $0.25
Lorpugo: posts big blind $0.50
*** HOLE CARDS ***
Dealt to Lorpugo [Th 2c]
worldethos: raises $0.70 to $1.20
Lorpugo: folds
Uncalled bet ($0.70) returned to worldethos
worldethos collected $1 from pot
worldethos: doesn't show hand
*** SUMMARY ***
Total pot $1 | Rake $0
Seat 1: worldethos (button) (small blind) collected ($1)
Seat 2: Lorpugo (big blind) folded before Flop


*********** # 88 **************
PokerStars Zoom Hand #235751341446: Hold'em No Limit ($0.25/$0.50) - 2022/04/26 15:22:04 ET
Table 'C Carinae' 2-max Seat #1 is the button
Seat 1: Lorpugo ($28.12 in chips)
Seat 2: worldethos ($97.05 in chips)
Lorpugo: posts small blind $0.25
worldethos: posts big blind $0.50
*** HOLE CARDS ***
Dealt to Lorpugo [Ks Ah]
Lorpugo: raises $0.60 to $1.10
worldethos: folds
Uncalled bet ($0.60) returned to Lorpugo
Lorpugo collected $1 from pot
Lorpugo: doesn't show hand
*** SUMMARY ***
Total pot $1 | Rake $0
Seat 1: Lorpugo (button) (small blind) collected ($1)
Seat 2: worldethos (big blind) folded before Flop


*********** # 89 **************
PokerStars Zoom Hand #235751338470: Hold'em No Limit ($0.25/$0.50) - 2022/04/26 15:21:57 ET
Table 'C Carinae' 2-max Seat #1 is the button
Seat 1: karakoK10 ($48.28 in chips)
Seat 2: Lorpugo ($27.87 in chips)
karakoK10: posts small blind $0.25
Lorpugo: posts big blind $0.50
*** HOLE CARDS ***
Dealt to Lorpugo [7s 6c]
karakoK10: folds
Uncalled bet ($0.25) returned to Lorpugo
Lorpugo collected $0.50 from pot
Lorpugo: doesn't show hand
*** SUMMARY ***
Total pot $0.50 | Rake $0
Seat 1: karakoK10 (button) (small blind) folded before Flop
Seat 2: Lorpugo (big blind) collected ($0.50)


*********** # 90 **************
PokerStars Zoom Hand #235751319104: Hold'em No Limit ($0.25/$0.50) - 2022/04/26 15:21:06 ET
Table 'C Carinae' 2-max Seat #1 is the button
Seat 1: PrinceViktor ($53.13 in chips)
Seat 2: Lorpugo ($29.91 in chips)
PrinceViktor: posts small blind $0.25
Lorpugo: posts big blind $0.50
*** HOLE CARDS ***
Dealt to Lorpugo [6c 8h]
PrinceViktor: raises $0.75 to $1.25
Lorpugo: calls $0.75
*** FLOP *** [Jc 5c 4c]
Lorpugo: checks
PrinceViktor: bets $0.79
Lorpugo: calls $0.79
*** TURN *** [Jc 5c 4c] [9s]
Lorpugo: checks
PrinceViktor: bets $1.28
Lorpugo: folds
Uncalled bet ($1.28) returned to PrinceViktor
PrinceViktor collected $3.83 from pot
PrinceViktor: doesn't show hand
*** SUMMARY ***
Total pot $4.08 | Rake $0.25
Board [Jc 5c 4c 9s]
Seat 1: PrinceViktor (button) (small blind) collected ($3.83)
Seat 2: Lorpugo (big blind) folded on the Turn


*********** # 91 **************
PokerStars Zoom Hand #235751301687: Hold'em No Limit ($0.25/$0.50) - 2022/04/26 15:20:21 ET
Table 'C Carinae' 2-max Seat #1 is the button
Seat 1: Lorpugo ($28.92 in chips)
Seat 2: gutsmnsglory ($61.67 in chips)
Lorpugo: posts small blind $0.25
gutsmnsglory: posts big blind $0.50
*** HOLE CARDS ***
Dealt to Lorpugo [3d 4d]
Lorpugo: raises $0.60 to $1.10
gutsmnsglory: calls $0.60
*** FLOP *** [8h 9c 3s]
gutsmnsglory: checks
Lorpugo: bets $0.69
gutsmnsglory: folds
Uncalled bet ($0.69) returned to Lorpugo
Lorpugo collected $2.09 from pot
Lorpugo: doesn't show hand
*** SUMMARY ***
Total pot $2.20 | Rake $0.11
Board [8h 9c 3s]
Seat 1: Lorpugo (button) (small blind) collected ($2.09)
Seat 2: gutsmnsglory (big blind) folded on the Flop


*********** # 92 **************
PokerStars Zoom Hand #235751297874: Hold'em No Limit ($0.25/$0.50) - 2022/04/26 15:20:11 ET
Table 'C Carinae' 2-max Seat #1 is the button
Seat 1: Lorpugo ($29.17 in chips)
Seat 2: BRoGeRZ ($32.64 in chips)
Lorpugo: posts small blind $0.25
BRoGeRZ: posts big blind $0.50
*** HOLE CARDS ***
Dealt to Lorpugo [2h 6h]
Lorpugo: folds
Uncalled bet ($0.25) returned to BRoGeRZ
BRoGeRZ collected $0.50 from pot
BRoGeRZ: doesn't show hand
*** SUMMARY ***
Total pot $0.50 | Rake $0
Seat 1: Lorpugo (button) (small blind) folded before Flop
Seat 2: BRoGeRZ (big blind) collected ($0.50)


*********** # 93 **************
PokerStars Zoom Hand #235751295133: Hold'em No Limit ($0.25/$0.50) - 2022/04/26 15:20:04 ET
Table 'C Carinae' 2-max Seat #1 is the button
Seat 1: Alek791 ($33.94 in chips)
Seat 2: Lorpugo ($28.92 in chips)
Alek791: posts small blind $0.25
Lorpugo: posts big blind $0.50
*** HOLE CARDS ***
Dealt to Lorpugo [4c 5d]
Alek791: folds
Uncalled bet ($0.25) returned to Lorpugo
Lorpugo collected $0.50 from pot
Lorpugo: doesn't show hand
Alek791 is disconnected
*** SUMMARY ***
Total pot $0.50 | Rake $0
Seat 1: Alek791 (button) (small blind) folded before Flop
Seat 2: Lorpugo (big blind) collected ($0.50)


*********** # 94 **************
PokerStars Zoom Hand #235751280034: Hold'em No Limit ($0.25/$0.50) - 2022/04/26 15:19:24 ET
Table 'C Carinae' 2-max Seat #1 is the button
Seat 1: karakoK10 ($48.98 in chips)
Seat 2: Lorpugo ($30.92 in chips)
karakoK10: posts small blind $0.25
Lorpugo: posts big blind $0.50
*** HOLE CARDS ***
Dealt to Lorpugo [8d Jh]
karakoK10: raises $1 to $1.50
Lorpugo: calls $1
*** FLOP *** [5h 3c 2d]
Lorpugo: bets $0.50
karakoK10: calls $0.50
*** TURN *** [5h 3c 2d] [9d]
Lorpugo: checks
karakoK10: bets $2.09
Lorpugo: folds
Uncalled bet ($2.09) returned to karakoK10
karakoK10 collected $3.80 from pot
karakoK10: doesn't show hand
*** SUMMARY ***
Total pot $4 | Rake $0.20
Board [5h 3c 2d 9d]
Seat 1: karakoK10 (button) (small blind) collected ($3.80)
Seat 2: Lorpugo (big blind) folded on the Turn


*********** # 95 **************
PokerStars Zoom Hand #235751258656: Hold'em No Limit ($0.25/$0.50) - 2022/04/26 15:18:28 ET
Table 'C Carinae' 2-max Seat #1 is the button
Seat 1: Lorpugo ($19.05 in chips)
Seat 2: karakoK10 ($50 in chips)
Lorpugo: posts small blind $0.25
karakoK10: posts big blind $0.50
*** HOLE CARDS ***
Dealt to Lorpugo [Qh Jh]
Lorpugo: raises $0.60 to $1.10
karakoK10: raises $2.90 to $4
Lorpugo: calls $2.90
*** FLOP *** [Qd 5d Jc]
karakoK10: checks
Lorpugo: checks
*** TURN *** [Qd 5d Jc] [Kh]
karakoK10: checks
Lorpugo: bets $3.75
karakoK10: calls $3.75
*** RIVER *** [Qd 5d Jc Kh] [Kc]
karakoK10: checks
Lorpugo: bets $4.87
karakoK10: calls $4.87
*** SHOW DOWN ***
Lorpugo: shows [Qh Jh] (two pair, Kings and Queens)
karakoK10: mucks hand
Lorpugo collected $24.49 from pot
*** SUMMARY ***
Total pot $25.24 | Rake $0.75
Board [Qd 5d Jc Kh Kc]
Seat 1: Lorpugo (button) (small blind) showed [Qh Jh] and won ($24.49) with two pair, Kings and Queens
Seat 2: karakoK10 (big blind) mucked [Jd Ac]


*********** # 96 **************
PokerStars Zoom Hand #235751255964: Hold'em No Limit ($0.25/$0.50) - 2022/04/26 15:18:21 ET
Table 'C Carinae' 2-max Seat #1 is the button
Seat 1: Alek791 ($27.63 in chips)
Seat 2: Lorpugo ($18.80 in chips)
Alek791: posts small blind $0.25
Lorpugo: posts big blind $0.50
*** HOLE CARDS ***
Dealt to Lorpugo [Kc Js]
Alek791: folds
Uncalled bet ($0.25) returned to Lorpugo
Lorpugo collected $0.50 from pot
Lorpugo: doesn't show hand
Alek791 is disconnected
*** SUMMARY ***
Total pot $0.50 | Rake $0
Seat 1: Alek791 (button) (small blind) folded before Flop
Seat 2: Lorpugo (big blind) collected ($0.50)


*********** # 97 **************
PokerStars Zoom Hand #235751236381: Hold'em No Limit ($0.25/$0.50) - 2022/04/26 15:17:30 ET
Table 'C Carinae' 2-max Seat #1 is the button
Seat 1: Lorpugo ($15.95 in chips)
Seat 2: E N L 22 ($39.50 in chips)
Lorpugo: posts small blind $0.25
E N L 22: posts big blind $0.50
*** HOLE CARDS ***
Dealt to Lorpugo [Th 6s]
Lorpugo: raises $0.50 to $1
E N L 22: calls $0.50
*** FLOP *** [6c 6h 5s]
E N L 22: checks
Lorpugo: bets $0.95
E N L 22: calls $0.95
*** TURN *** [6c 6h 5s] [Js]
E N L 22: checks
Lorpugo: bets $1.22
E N L 22: calls $1.22
*** RIVER *** [6c 6h 5s Js] [Ac]
E N L 22: checks
Lorpugo: bets $12.78 and is all-in
E N L 22: folds
Uncalled bet ($12.78) returned to Lorpugo
Lorpugo collected $6.02 from pot
Lorpugo: doesn't show hand
E N L 22 is disconnected
*** SUMMARY ***
Total pot $6.34 | Rake $0.32
Board [6c 6h 5s Js Ac]
Seat 1: Lorpugo (button) (small blind) collected ($6.02)
Seat 2: E N L 22 (big blind) folded on the River


*********** # 98 **************
PokerStars Zoom Hand #235751223174: Hold'em No Limit ($0.25/$0.50) - 2022/04/26 15:16:55 ET
Table 'C Carinae' 2-max Seat #1 is the button
Seat 1: TheBluffPL ($101.45 in chips)
Seat 2: Lorpugo ($19.95 in chips)
TheBluffPL: posts small blind $0.25
Lorpugo: posts big blind $0.50
*** HOLE CARDS ***
Dealt to Lorpugo [4d Ac]
TheBluffPL: raises $0.75 to $1.25
Lorpugo: raises $2.75 to $4
TheBluffPL: raises $31 to $35
Lorpugo: folds
Uncalled bet ($31) returned to TheBluffPL
TheBluffPL collected $8 from pot
TheBluffPL: doesn't show hand
*** SUMMARY ***
Total pot $8 | Rake $0
Seat 1: TheBluffPL (button) (small blind) collected ($8)
Seat 2: Lorpugo (big blind) folded before Flop


*********** # 99 **************
PokerStars Zoom Hand #235751212630: Hold'em No Limit ($0.25/$0.50) - 2022/04/26 15:16:27 ET
Table 'C Carinae' 2-max Seat #1 is the button
Seat 1: Lorpugo ($21.05 in chips)
Seat 2: xRhythm ($52.38 in chips)
Lorpugo: posts small blind $0.25
xRhythm: posts big blind $0.50
*** HOLE CARDS ***
Dealt to Lorpugo [5d 7s]
Lorpugo: raises $0.60 to $1.10
xRhythm: raises $3.40 to $4.50
Lorpugo: folds
Uncalled bet ($3.40) returned to xRhythm
xRhythm collected $2.20 from pot
xRhythm: doesn't show hand
*** SUMMARY ***
Total pot $2.20 | Rake $0
Seat 1: Lorpugo (button) (small blind) folded before Flop
Seat 2: xRhythm (big blind) collected ($2.20)


*********** # 100 **************
PokerStars Zoom Hand #235751205344: Hold'em No Limit ($0.25/$0.50) - 2022/04/26 15:16:08 ET
Table 'C Carinae' 2-max Seat #1 is the button
Seat 1: PrinceViktor ($53.45 in chips)
Seat 2: Lorpugo ($21.55 in chips)
PrinceViktor: posts small blind $0.25
Lorpugo: posts big blind $0.50
*** HOLE CARDS ***
Dealt to Lorpugo [2s Kc]
PrinceViktor: raises $0.75 to $1.25
Lorpugo: folds
Uncalled bet ($0.75) returned to PrinceViktor
PrinceViktor collected $1 from pot
PrinceViktor: doesn't show hand
*** SUMMARY ***
Total pot $1 | Rake $0
Seat 1: PrinceViktor (button) (small blind) collected ($1)
Seat 2: Lorpugo (big blind) folded before Flop


*********** # 101 **************
PokerStars Zoom Hand #235751190031: Hold'em No Limit ($0.25/$0.50) - 2022/04/26 15:15:28 ET
Table 'C Carinae' 2-max Seat #1 is the button
Seat 1: Lorpugo ($20.52 in chips)
Seat 2: PrinceViktor ($52.61 in chips)
Lorpugo: posts small blind $0.25
PrinceViktor: posts big blind $0.50
*** HOLE CARDS ***
Dealt to Lorpugo [3s As]
Lorpugo: raises $0.65 to $1.15
PrinceViktor: calls $0.65
*** FLOP *** [3d 6h Ad]
PrinceViktor: checks
Lorpugo: bets $0.72
PrinceViktor: folds
Uncalled bet ($0.72) returned to Lorpugo
Lorpugo collected $2.18 from pot
Lorpugo: doesn't show hand
*** SUMMARY ***
Total pot $2.30 | Rake $0.12
Board [3d 6h Ad]
Seat 1: Lorpugo (button) (small blind) collected ($2.18)
Seat 2: PrinceViktor (big blind) folded on the Flop


*********** # 102 **************
PokerStars Zoom Hand #235751174951: Hold'em No Limit ($0.25/$0.50) - 2022/04/26 15:14:48 ET
Table 'C Carinae' 2-max Seat #1 is the button
Seat 1: MeryjanePL ($48.23 in chips)
Seat 2: Lorpugo ($22.02 in chips)
MeryjanePL: posts small blind $0.25
Lorpugo: posts big blind $0.50
*** HOLE CARDS ***
Dealt to Lorpugo [5h 3h]
MeryjanePL: raises $1 to $1.50
Lorpugo: calls $1
*** FLOP *** [Th 2s Ts]
Lorpugo: checks
MeryjanePL: bets $1.43
Lorpugo: folds
Uncalled bet ($1.43) returned to MeryjanePL
MeryjanePL collected $2.85 from pot
MeryjanePL: doesn't show hand
*** SUMMARY ***
Total pot $3 | Rake $0.15
Board [Th 2s Ts]
Seat 1: MeryjanePL (button) (small blind) collected ($2.85)
Seat 2: Lorpugo (big blind) folded on the Flop


*********** # 103 **************
PokerStars Zoom Hand #235751171734: Hold'em No Limit ($0.25/$0.50) - 2022/04/26 15:14:40 ET
Table 'C Carinae' 2-max Seat #1 is the button
Seat 1: Lorpugo ($22.27 in chips)
Seat 2: MeryjanePL ($39 in chips)
Lorpugo: posts small blind $0.25
MeryjanePL: posts big blind $0.50
*** HOLE CARDS ***
Dealt to Lorpugo [4c 7s]
Lorpugo: folds
Uncalled bet ($0.25) returned to MeryjanePL
MeryjanePL collected $0.50 from pot
MeryjanePL: doesn't show hand
*** SUMMARY ***
Total pot $0.50 | Rake $0
Seat 1: Lorpugo (button) (small blind) folded before Flop
Seat 2: MeryjanePL (big blind) collected ($0.50)


*********** # 104 **************
PokerStars Zoom Hand #235751169115: Hold'em No Limit ($0.25/$0.50) - 2022/04/26 15:14:33 ET
Table 'C Carinae' 2-max Seat #1 is the button
Seat 1: jutswining ($56.72 in chips)
Seat 2: Lorpugo ($22.02 in chips)
jutswining: posts small blind $0.25
Lorpugo: posts big blind $0.50
*** HOLE CARDS ***
Dealt to Lorpugo [3s 8d]
jutswining: folds
Uncalled bet ($0.25) returned to Lorpugo
Lorpugo collected $0.50 from pot
Lorpugo: doesn't show hand
jutswining is disconnected
*** SUMMARY ***
Total pot $0.50 | Rake $0
Seat 1: jutswining (button) (small blind) folded before Flop
Seat 2: Lorpugo (big blind) collected ($0.50)


*********** # 105 **************
PokerStars Zoom Hand #235751164918: Hold'em No Limit ($0.25/$0.50) - 2022/04/26 15:14:22 ET
Table 'C Carinae' 2-max Seat #1 is the button
Seat 1: Lorpugo ($21.52 in chips)
Seat 2: jutswining ($57.22 in chips)
Lorpugo: posts small blind $0.25
jutswining: posts big blind $0.50
*** HOLE CARDS ***
Dealt to Lorpugo [4c 6s]
Lorpugo: raises $0.50 to $1
jutswining: folds
Uncalled bet ($0.50) returned to Lorpugo
Lorpugo collected $1 from pot
Lorpugo: doesn't show hand
jutswining is disconnected
*** SUMMARY ***
Total pot $1 | Rake $0
Seat 1: Lorpugo (button) (small blind) collected ($1)
Seat 2: jutswining (big blind) folded before Flop


*********** # 106 **************
PokerStars Zoom Hand #235751155327: Hold'em No Limit ($0.25/$0.50) - 2022/04/26 15:13:57 ET
Table 'C Carinae' 2-max Seat #1 is the button
Seat 1: Lorpugo ($20.53 in chips)
Seat 2: jr.borsec ($24.24 in chips)
Lorpugo: posts small blind $0.25
jr.borsec: posts big blind $0.50
*** HOLE CARDS ***
Dealt to Lorpugo [Ah As]
Lorpugo: raises $0.60 to $1.10
jr.borsec: calls $0.60
*** FLOP *** [4d 5c 5h]
jr.borsec: checks
Lorpugo: bets $1.10
jr.borsec: folds
Uncalled bet ($1.10) returned to Lorpugo
Lorpugo collected $2.09 from pot
Lorpugo: doesn't show hand
jr.borsec is disconnected
*** SUMMARY ***
Total pot $2.20 | Rake $0.11
Board [4d 5c 5h]
Seat 1: Lorpugo (button) (small blind) collected ($2.09)
Seat 2: jr.borsec (big blind) folded on the Flop


*********** # 107 **************
PokerStars Zoom Hand #235751150080: Hold'em No Limit ($0.25/$0.50) - 2022/04/26 15:13:43 ET
Table 'C Carinae' 2-max Seat #1 is the button
Seat 1: Alek791 ($43.36 in chips)
Seat 2: Lorpugo ($21.03 in chips)
Alek791: posts small blind $0.25
Lorpugo: posts big blind $0.50
*** HOLE CARDS ***
Dealt to Lorpugo [Ts 4d]
Alek791: raises $0.50 to $1
Lorpugo: folds
Uncalled bet ($0.50) returned to Alek791
Alek791 collected $1 from pot
Alek791: doesn't show hand
*** SUMMARY ***
Total pot $1 | Rake $0
Seat 1: Alek791 (button) (small blind) collected ($1)
Seat 2: Lorpugo (big blind) folded before Flop


*********** # 108 **************
PokerStars Zoom Hand #235751144945: Hold'em No Limit ($0.25/$0.50) - 2022/04/26 15:13:29 ET
Table 'C Carinae' 2-max Seat #1 is the button
Seat 1: PrinceViktor ($50 in chips)
Seat 2: Lorpugo ($21.53 in chips)
PrinceViktor: posts small blind $0.25
Lorpugo: posts big blind $0.50
*** HOLE CARDS ***
Dealt to Lorpugo [2d Js]
PrinceViktor: raises $0.75 to $1.25
Lorpugo: folds
Uncalled bet ($0.75) returned to PrinceViktor
PrinceViktor collected $1 from pot
PrinceViktor: doesn't show hand
*** SUMMARY ***
Total pot $1 | Rake $0
Seat 1: PrinceViktor (button) (small blind) collected ($1)
Seat 2: Lorpugo (big blind) folded before Flop


*********** # 109 **************
PokerStars Zoom Hand #235751140088: Hold'em No Limit ($0.25/$0.50) - 2022/04/26 15:13:16 ET
Table 'C Carinae' 2-max Seat #1 is the button
Seat 1: TheBluffPL ($54.16 in chips)
Seat 2: Lorpugo ($22.03 in chips)
TheBluffPL: posts small blind $0.25
Lorpugo: posts big blind $0.50
*** HOLE CARDS ***
Dealt to Lorpugo [6c 2h]
TheBluffPL: raises $0.75 to $1.25
Lorpugo: folds
Uncalled bet ($0.75) returned to TheBluffPL
TheBluffPL collected $1 from pot
TheBluffPL: doesn't show hand
*** SUMMARY ***
Total pot $1 | Rake $0
Seat 1: TheBluffPL (button) (small blind) collected ($1)
Seat 2: Lorpugo (big blind) folded before Flop


*********** # 110 **************
PokerStars Zoom Hand #235751134995: Hold'em No Limit ($0.25/$0.50) - 2022/04/26 15:13:02 ET
Table 'C Carinae' 2-max Seat #1 is the button
Seat 1: Lorpugo ($21.53 in chips)
Seat 2: TheBluffPL ($54.66 in chips)
Lorpugo: posts small blind $0.25
TheBluffPL: posts big blind $0.50
*** HOLE CARDS ***
Dealt to Lorpugo [7c 9d]
Lorpugo: raises $0.70 to $1.20
TheBluffPL: folds
Uncalled bet ($0.70) returned to Lorpugo
Lorpugo collected $1 from pot
Lorpugo: doesn't show hand
*** SUMMARY ***
Total pot $1 | Rake $0
Seat 1: Lorpugo (button) (small blind) collected ($1)
Seat 2: TheBluffPL (big blind) folded before Flop


*********** # 111 **************
PokerStars Zoom Hand #235751130989: Hold'em No Limit ($0.25/$0.50) - 2022/04/26 15:12:51 ET
Table 'C Carinae' 2-max Seat #1 is the button
Seat 1: Lorpugo ($21.03 in chips)
Seat 2: karakoK10 ($56.71 in chips)
Lorpugo: posts small blind $0.25
karakoK10: posts big blind $0.50
*** HOLE CARDS ***
Dealt to Lorpugo [7d 7h]
Lorpugo: raises $0.60 to $1.10
karakoK10: folds
Uncalled bet ($0.60) returned to Lorpugo
Lorpugo collected $1 from pot
Lorpugo: doesn't show hand
*** SUMMARY ***
Total pot $1 | Rake $0
Seat 1: Lorpugo (button) (small blind) collected ($1)
Seat 2: karakoK10 (big blind) folded before Flop


*********** # 112 **************
PokerStars Zoom Hand #235751097747: Hold'em No Limit ($0.25/$0.50) - 2022/04/26 15:11:46 ET
Table 'C Carinae' 2-max Seat #1 is the button
Seat 1: karakoK10 ($56.82 in chips)
Seat 2: Lorpugo ($21.13 in chips)
karakoK10: posts small blind $0.25
Lorpugo: posts big blind $0.50
*** HOLE CARDS ***
Dealt to Lorpugo [Jh 3h]
karakoK10: calls $0.25
Lorpugo: checks
*** FLOP *** [4d 7d 3s]
Lorpugo: checks
karakoK10: checks
*** TURN *** [4d 7d 3s] [Js]
Lorpugo: bets $1.60
karakoK10: calls $1.60
*** RIVER *** [4d 7d 3s Js] [7c]
Lorpugo: checks
karakoK10: checks
*** SHOW DOWN ***
Lorpugo: shows [Jh 3h] (two pair, Jacks and Sevens)
karakoK10: shows [Jd 2d] (two pair, Jacks and Sevens)
Lorpugo collected $2 from pot
karakoK10 collected $1.99 from pot
*** SUMMARY ***
Total pot $4.20 | Rake $0.21
Board [4d 7d 3s Js 7c]
Seat 1: karakoK10 (button) (small blind) showed [Jd 2d] and won ($1.99) with two pair, Jacks and Sevens
Seat 2: Lorpugo (big blind) showed [Jh 3h] and won ($2) with two pair, Jacks and Sevens


*********** # 113 **************
PokerStars Zoom Hand #235751059206: Hold'em No Limit ($0.25/$0.50) - 2022/04/26 15:10:04 ET
Table 'C Carinae' 2-max Seat #1 is the button
Seat 1: Lorpugo ($33.30 in chips)
Seat 2: TheBluffPL ($50 in chips)
Lorpugo: posts small blind $0.25
TheBluffPL: posts big blind $0.50
*** HOLE CARDS ***
Dealt to Lorpugo [Jc 4c]
Lorpugo: raises $0.60 to $1.10
TheBluffPL: calls $0.60
*** FLOP *** [Th 7d Ks]
TheBluffPL: checks
Lorpugo: checks
*** TURN *** [Th 7d Ks] [Qs]
TheBluffPL: bets $1.57
Lorpugo: calls $1.57
*** RIVER *** [Th 7d Ks Qs] [7h]
TheBluffPL: bets $3.80
Lorpugo: raises $5.70 to $9.50
TheBluffPL: raises $37.83 to $47.33 and is all-in
Lorpugo: folds
Uncalled bet ($37.83) returned to TheBluffPL
TheBluffPL collected $23.59 from pot
TheBluffPL: doesn't show hand
*** SUMMARY ***
Total pot $24.34 | Rake $0.75
Board [Th 7d Ks Qs 7h]
Seat 1: Lorpugo (button) (small blind) folded on the River
Seat 2: TheBluffPL (big blind) collected ($23.59)


*********** # 114 **************
PokerStars Zoom Hand #235751051562: Hold'em No Limit ($0.25/$0.50) - 2022/04/26 15:09:44 ET
Table 'C Carinae' 2-max Seat #1 is the button
Seat 1: TheBluffPL ($51.25 in chips)
Seat 2: Lorpugo ($32.05 in chips)
TheBluffPL: posts small blind $0.25
Lorpugo: posts big blind $0.50
*** HOLE CARDS ***
Dealt to Lorpugo [9h 9d]
TheBluffPL: raises $0.75 to $1.25
Lorpugo: raises $2.75 to $4
TheBluffPL: folds
Uncalled bet ($2.75) returned to Lorpugo
Lorpugo collected $2.50 from pot
Lorpugo: doesn't show hand
*** SUMMARY ***
Total pot $2.50 | Rake $0
Seat 1: TheBluffPL (button) (small blind) folded before Flop
Seat 2: Lorpugo (big blind) collected ($2.50)


*********** # 115 **************
PokerStars Zoom Hand #235751039632: Hold'em No Limit ($0.25/$0.50) - 2022/04/26 15:09:12 ET
Table 'C Carinae' 2-max Seat #1 is the button
Seat 1: Lorpugo ($33.15 in chips)
Seat 2: worldethos ($50.81 in chips)
Lorpugo: posts small blind $0.25
worldethos: posts big blind $0.50
*** HOLE CARDS ***
Dealt to Lorpugo [Ad 9s]
Lorpugo: raises $0.60 to $1.10
worldethos: raises $2.40 to $3.50
Lorpugo: folds
Uncalled bet ($2.40) returned to worldethos
worldethos collected $2.20 from pot
worldethos: doesn't show hand
*** SUMMARY ***
Total pot $2.20 | Rake $0
Seat 1: Lorpugo (button) (small blind) folded before Flop
Seat 2: worldethos (big blind) collected ($2.20)


*********** # 116 **************
PokerStars Zoom Hand #235751005097: Hold'em No Limit ($0.25/$0.50) - 2022/04/26 15:07:40 ET
Table 'C Carinae' 2-max Seat #1 is the button
Seat 1: worldethos ($52.92 in chips)
Seat 2: Lorpugo ($31.25 in chips)
worldethos: posts small blind $0.25
Lorpugo: posts big blind $0.50
*** HOLE CARDS ***
Dealt to Lorpugo [Jd 4d]
worldethos: raises $0.70 to $1.20
Lorpugo: calls $0.70
*** FLOP *** [4h 9c 9h]
Lorpugo: checks
worldethos: bets $0.91
Lorpugo: calls $0.91
*** TURN *** [4h 9c 9h] [5c]
Lorpugo: checks
worldethos: checks
*** RIVER *** [4h 9c 9h 5c] [Qd]
Lorpugo: checks
worldethos: checks
*** SHOW DOWN ***
Lorpugo: shows [Jd 4d] (two pair, Nines and Fours)
worldethos: mucks hand
Lorpugo collected $4.01 from pot
*** SUMMARY ***
Total pot $4.22 | Rake $0.21
Board [4h 9c 9h 5c Qd]
Seat 1: worldethos (button) (small blind) mucked [6d Tc]
Seat 2: Lorpugo (big blind) showed [Jd 4d] and won ($4.01) with two pair, Nines and Fours


*********** # 117 **************
PokerStars Zoom Hand #235750995411: Hold'em No Limit ($0.25/$0.50) - 2022/04/26 15:07:14 ET
Table 'C Carinae' 2-max Seat #1 is the button
Seat 1: Lorpugo ($32.41 in chips)
Seat 2: TheBluffPL ($55.72 in chips)
Lorpugo: posts small blind $0.25
TheBluffPL: posts big blind $0.50
*** HOLE CARDS ***
Dealt to Lorpugo [Qc 4c]
Lorpugo: raises $0.66 to $1.16
TheBluffPL: raises $3.84 to $5
Lorpugo: folds
Uncalled bet ($3.84) returned to TheBluffPL
TheBluffPL collected $2.32 from pot
TheBluffPL: doesn't show hand
*** SUMMARY ***
Total pot $2.32 | Rake $0
Seat 1: Lorpugo (button) (small blind) folded before Flop
Seat 2: TheBluffPL (big blind) collected ($2.32)


*********** # 118 **************
PokerStars Zoom Hand #235750976133: Hold'em No Limit ($0.25/$0.50) - 2022/04/26 15:06:23 ET
Table 'C Carinae' 2-max Seat #1 is the button
Seat 1: E N L 22 ($83.55 in chips)
Seat 2: Lorpugo ($33.41 in chips)
E N L 22: posts small blind $0.25
Lorpugo: posts big blind $0.50
*** HOLE CARDS ***
Dealt to Lorpugo [7h Th]
E N L 22: calls $0.25
Lorpugo: checks
*** FLOP *** [7s Kd 6c]
Lorpugo: checks
E N L 22: checks
*** TURN *** [7s Kd 6c] [5h]
Lorpugo: bets $0.50
E N L 22: calls $0.50
*** RIVER *** [7s Kd 6c 5h] [9h]
Lorpugo: checks
E N L 22: checks
*** SHOW DOWN ***
Lorpugo: shows [7h Th] (a pair of Sevens)
E N L 22: shows [9d Jc] (a pair of Nines)
E N L 22 collected $1.88 from pot
*** SUMMARY ***
Total pot $2 | Rake $0.12
Board [7s Kd 6c 5h 9h]
Seat 1: E N L 22 (button) (small blind) showed [9d Jc] and won ($1.88) with a pair of Nines
Seat 2: Lorpugo (big blind) showed [7h Th] and lost with a pair of Sevens


*********** # 119 **************
PokerStars Zoom Hand #235750969720: Hold'em No Limit ($0.25/$0.50) - 2022/04/26 15:06:06 ET
Table 'C Carinae' 2-max Seat #1 is the button
Seat 1: Lorpugo ($32.91 in chips)
Seat 2: MeryjanePL ($55.23 in chips)
Lorpugo: posts small blind $0.25
MeryjanePL: posts big blind $0.50
*** HOLE CARDS ***
Dealt to Lorpugo [6c Kh]
Lorpugo: raises $0.60 to $1.10
MeryjanePL: folds
Uncalled bet ($0.60) returned to Lorpugo
Lorpugo collected $1 from pot
Lorpugo: doesn't show hand
*** SUMMARY ***
Total pot $1 | Rake $0
Seat 1: Lorpugo (button) (small blind) collected ($1)
Seat 2: MeryjanePL (big blind) folded before Flop


*********** # 120 **************
PokerStars Zoom Hand #235750945636: Hold'em No Limit ($0.25/$0.50) - 2022/04/26 15:05:01 ET
Table 'C Carinae' 2-max Seat #1 is the button
Seat 1: MeryjanePL ($53.69 in chips)
Seat 2: Lorpugo ($34.62 in chips)
MeryjanePL: posts small blind $0.25
Lorpugo: posts big blind $0.50
*** HOLE CARDS ***
Dealt to Lorpugo [4d 8d]
MeryjanePL: raises $0.55 to $1.05
Lorpugo: calls $0.55
*** FLOP *** [3d 9d Ah]
Lorpugo: checks
MeryjanePL: bets $0.66
Lorpugo: calls $0.66
*** TURN *** [3d 9d Ah] [Ts]
Lorpugo: checks
MeryjanePL: checks
*** RIVER *** [3d 9d Ah Ts] [Kc]
Lorpugo: checks
MeryjanePL: checks
*** SHOW DOWN ***
Lorpugo: shows [4d 8d] (high card Ace)
MeryjanePL: shows [Ks 5c] (a pair of Kings)
MeryjanePL collected $3.25 from pot
*** SUMMARY ***
Total pot $3.42 | Rake $0.17
Board [3d 9d Ah Ts Kc]
Seat 1: MeryjanePL (button) (small blind) showed [Ks 5c] and won ($3.25) with a pair of Kings
Seat 2: Lorpugo (big blind) showed [4d 8d] and lost with high card Ace


*********** # 121 **************
PokerStars Zoom Hand #235750941537: Hold'em No Limit ($0.25/$0.50) - 2022/04/26 15:04:50 ET
Table 'C Carinae' 2-max Seat #1 is the button
Seat 1: Lorpugo ($34.87 in chips)
Seat 2: karakoK10 ($55.11 in chips)
Lorpugo: posts small blind $0.25
karakoK10: posts big blind $0.50
*** HOLE CARDS ***
Dealt to Lorpugo [Ts 4c]
Lorpugo: folds
Uncalled bet ($0.25) returned to karakoK10
karakoK10 collected $0.50 from pot
karakoK10: doesn't show hand
*** SUMMARY ***
Total pot $0.50 | Rake $0
Seat 1: Lorpugo (button) (small blind) folded before Flop
Seat 2: karakoK10 (big blind) collected ($0.50)


*********** # 122 **************
PokerStars Zoom Hand #235750939244: Hold'em No Limit ($0.25/$0.50) - 2022/04/26 15:04:43 ET
Table 'C Carinae' 2-max Seat #1 is the button
Seat 1: Ares656 ($77.74 in chips)
Seat 2: Lorpugo ($34.62 in chips)
Ares656: posts small blind $0.25
Lorpugo: posts big blind $0.50
*** HOLE CARDS ***
Dealt to Lorpugo [8s 9h]
Ares656: folds
Uncalled bet ($0.25) returned to Lorpugo
Lorpugo collected $0.50 from pot
Lorpugo: doesn't show hand
*** SUMMARY ***
Total pot $0.50 | Rake $0
Seat 1: Ares656 (button) (small blind) folded before Flop
Seat 2: Lorpugo (big blind) collected ($0.50)


*********** # 123 **************
PokerStars Zoom Hand #235750936488: Hold'em No Limit ($0.25/$0.50) - 2022/04/26 15:04:36 ET
Table 'C Carinae' 2-max Seat #1 is the button
Seat 1: Lorpugo ($34.87 in chips)
Seat 2: MagicViuff ($78.43 in chips)
Lorpugo: posts small blind $0.25
MagicViuff: posts big blind $0.50
*** HOLE CARDS ***
Dealt to Lorpugo [Ts 4c]
Lorpugo: folds
Uncalled bet ($0.25) returned to MagicViuff
MagicViuff collected $0.50 from pot
MagicViuff: doesn't show hand
*** SUMMARY ***
Total pot $0.50 | Rake $0
Seat 1: Lorpugo (button) (small blind) folded before Flop
Seat 2: MagicViuff (big blind) collected ($0.50)


*********** # 124 **************
PokerStars Zoom Hand #235750933759: Hold'em No Limit ($0.25/$0.50) - 2022/04/26 15:04:28 ET
Table 'C Carinae' 2-max Seat #1 is the button
Seat 1: Ethernion ($98.42 in chips)
Seat 2: Lorpugo ($34.62 in chips)
Ethernion: posts small blind $0.25
Lorpugo: posts big blind $0.50
*** HOLE CARDS ***
Dealt to Lorpugo [5c Ks]
Ethernion: folds
Uncalled bet ($0.25) returned to Lorpugo
Lorpugo collected $0.50 from pot
Lorpugo: doesn't show hand
*** SUMMARY ***
Total pot $0.50 | Rake $0
Seat 1: Ethernion (button) (small blind) folded before Flop
Seat 2: Lorpugo (big blind) collected ($0.50)


*********** # 125 **************
PokerStars Zoom Hand #235750900900: Hold'em No Limit ($0.25/$0.50) - 2022/04/26 15:03:12 ET
Table 'C Carinae' 2-max Seat #1 is the button
Seat 1: MeryjanePL ($51.27 in chips)
Seat 2: Lorpugo ($36.44 in chips)
MeryjanePL: posts small blind $0.25
Lorpugo: posts big blind $0.50
*** HOLE CARDS ***
Dealt to Lorpugo [8s Tc]
MeryjanePL: raises $0.75 to $1.25
Lorpugo: calls $0.75
*** FLOP *** [3s Qd 4s]
Lorpugo: checks
MeryjanePL: bets $0.57
Lorpugo: calls $0.57
*** TURN *** [3s Qd 4s] [7d]
Lorpugo: checks
MeryjanePL: checks
*** RIVER *** [3s Qd 4s 7d] [Js]
Lorpugo: checks
MeryjanePL: checks
*** SHOW DOWN ***
Lorpugo: shows [8s Tc] (high card Queen)
MeryjanePL: shows [Kd Th] (high card King)
MeryjanePL collected $3.46 from pot
*** SUMMARY ***
Total pot $3.64 | Rake $0.18
Board [3s Qd 4s 7d Js]
Seat 1: MeryjanePL (button) (small blind) showed [Kd Th] and won ($3.46) with high card King
Seat 2: Lorpugo (big blind) showed [8s Tc] and lost with high card Queen


*********** # 126 **************
PokerStars Zoom Hand #235750897315: Hold'em No Limit ($0.25/$0.50) - 2022/04/26 15:03:02 ET
Table 'C Carinae' 2-max Seat #1 is the button
Seat 1: Lorpugo ($36.69 in chips)
Seat 2: jutswining ($115.20 in chips)
Lorpugo: posts small blind $0.25
jutswining: posts big blind $0.50
*** HOLE CARDS ***
Dealt to Lorpugo [9d 3s]
Lorpugo: folds
Uncalled bet ($0.25) returned to jutswining
jutswining collected $0.50 from pot
jutswining: doesn't show hand
*** SUMMARY ***
Total pot $0.50 | Rake $0
Seat 1: Lorpugo (button) (small blind) folded before Flop
Seat 2: jutswining (big blind) collected ($0.50)


*********** # 127 **************
PokerStars Zoom Hand #235750868350: Hold'em No Limit ($0.25/$0.50) - 2022/04/26 15:01:42 ET
Table 'C Carinae' 2-max Seat #1 is the button
Seat 1: Lorpugo ($33.76 in chips)
Seat 2: xRhythm ($60.52 in chips)
Lorpugo: posts small blind $0.25
xRhythm: posts big blind $0.50
*** HOLE CARDS ***
Dealt to Lorpugo [4s As]
Lorpugo: raises $0.60 to $1.10
xRhythm: calls $0.60
*** FLOP *** [3d Js Jc]
xRhythm: checks
Lorpugo: bets $0.69
xRhythm: raises $1.46 to $2.15
Lorpugo: calls $1.46
*** TURN *** [3d Js Jc] [Qh]
xRhythm: checks
Lorpugo: bets $2.60
xRhythm: folds
Uncalled bet ($2.60) returned to Lorpugo
Lorpugo collected $6.18 from pot
Lorpugo: doesn't show hand
*** SUMMARY ***
Total pot $6.50 | Rake $0.32
Board [3d Js Jc Qh]
Seat 1: Lorpugo (button) (small blind) collected ($6.18)
Seat 2: xRhythm (big blind) folded on the Turn


*********** # 128 **************
PokerStars Zoom Hand #235750853401: Hold'em No Limit ($0.25/$0.50) - 2022/04/26 15:00:56 ET
Table 'C Carinae' 2-max Seat #1 is the button
Seat 1: Lorpugo ($31.29 in chips)
Seat 2: Niclazzz ($36.12 in chips)
Lorpugo: posts small blind $0.25
Niclazzz: posts big blind $0.50
*** HOLE CARDS ***
Dealt to Lorpugo [5h Kh]
Lorpugo: raises $0.60 to $1.10
Niclazzz: calls $0.60
*** FLOP *** [6s Kc 6h]
Niclazzz: checks
Lorpugo: bets $0.69
Niclazzz: calls $0.69
*** TURN *** [6s Kc 6h] [Ad]
Niclazzz: checks
Lorpugo: bets $0.95
Niclazzz: calls $0.95
*** RIVER *** [6s Kc 6h Ad] [6c]
Niclazzz: checks
Lorpugo: checks
*** SHOW DOWN ***
Niclazzz: shows [3h 3d] (a full house, Sixes full of Threes)
Lorpugo: shows [5h Kh] (a full house, Sixes full of Kings)
Lorpugo collected $5.21 from pot
*** SUMMARY ***
Total pot $5.48 | Rake $0.27
Board [6s Kc 6h Ad 6c]
Seat 1: Lorpugo (button) (small blind) showed [5h Kh] and won ($5.21) with a full house, Sixes full of Kings
Seat 2: Niclazzz (big blind) showed [3h 3d] and lost with a full house, Sixes full of Threes


*********** # 129 **************
PokerStars Zoom Hand #235750843443: Hold'em No Limit ($0.25/$0.50) - 2022/04/26 15:00:23 ET
Table 'C Carinae' 2-max Seat #1 is the button
Seat 1: Niclazzz ($40.62 in chips)
Seat 2: Lorpugo ($27.24 in chips)
Niclazzz: posts small blind $0.25
Lorpugo: posts big blind $0.50
*** HOLE CARDS ***
Dealt to Lorpugo [Jd Js]
Niclazzz: raises $1 to $1.50
Lorpugo: raises $3 to $4.50
Niclazzz: calls $3
*** FLOP *** [3d 3h Kh]
Lorpugo: bets $2.82
Niclazzz: folds
Uncalled bet ($2.82) returned to Lorpugo
Lorpugo collected $8.55 from pot
Lorpugo: doesn't show hand
Niclazzz is disconnected
*** SUMMARY ***
Total pot $9 | Rake $0.45
Board [3d 3h Kh]
Seat 1: Niclazzz (button) (small blind) folded on the Flop
Seat 2: Lorpugo (big blind) collected ($8.55)


*********** # 130 **************
PokerStars Zoom Hand #235750835754: Hold'em No Limit ($0.25/$0.50) - 2022/04/26 14:59:56 ET
Table 'C Carinae' 2-max Seat #1 is the button
Seat 1: iulian3000 ($67.09 in chips)
Seat 2: Lorpugo ($25.75 in chips)
iulian3000: posts small blind $0.25
Lorpugo: posts big blind $0.50
*** HOLE CARDS ***
Dealt to Lorpugo [9s Ah]
iulian3000: calls $0.25
Lorpugo: raises $1.15 to $1.65
iulian3000: calls $1.15
*** FLOP *** [2s Tc 7h]
Lorpugo: bets $1.04
iulian3000: folds
Uncalled bet ($1.04) returned to Lorpugo
Lorpugo collected $3.14 from pot
Lorpugo: doesn't show hand
*** SUMMARY ***
Total pot $3.30 | Rake $0.16
Board [2s Tc 7h]
Seat 1: iulian3000 (button) (small blind) folded on the Flop
Seat 2: Lorpugo (big blind) collected ($3.14)


*********** # 131 **************
PokerStars Zoom Hand #235750832405: Hold'em No Limit ($0.25/$0.50) - 2022/04/26 14:59:44 ET
Table 'C Carinae' 2-max Seat #1 is the button
Seat 1: Lorpugo ($25.25 in chips)
Seat 2: worldethos ($50 in chips)
Lorpugo: posts small blind $0.25
worldethos: posts big blind $0.50
*** HOLE CARDS ***
Dealt to Lorpugo [5h 8s]
Lorpugo: raises $0.50 to $1
worldethos: folds
Uncalled bet ($0.50) returned to Lorpugo
Lorpugo collected $1 from pot
Lorpugo: doesn't show hand
*** SUMMARY ***
Total pot $1 | Rake $0
Seat 1: Lorpugo (button) (small blind) collected ($1)
Seat 2: worldethos (big blind) folded before Flop


*********** # 132 **************
PokerStars Zoom Hand #235750830075: Hold'em No Limit ($0.25/$0.50) - 2022/04/26 14:59:36 ET
Table 'C Carinae' 2-max Seat #1 is the button
Seat 1: Niclazzz ($39.99 in chips)
Seat 2: Lorpugo ($25 in chips)
Niclazzz: posts small blind $0.25
Lorpugo: posts big blind $0.50
*** HOLE CARDS ***
Dealt to Lorpugo [Qd 3d]
Niclazzz: folds
Uncalled bet ($0.25) returned to Lorpugo
Lorpugo collected $0.50 from pot
Lorpugo: doesn't show hand
Niclazzz is disconnected
*** SUMMARY ***
Total pot $0.50 | Rake $0
Seat 1: Niclazzz (button) (small blind) folded before Flop
Seat 2: Lorpugo (big blind) collected ($0.50)


*********** # 133 **************
PokerStars Zoom Hand #235750828744: Hold'em No Limit ($0.25/$0.50) - 2022/04/26 14:59:31 ET
Table 'C Carinae' 2-max Seat #1 is the button
Seat 1: Ares656 ($52.38 in chips)
Seat 2: Lorpugo ($24.75 in chips)
Ares656: posts small blind $0.25
Lorpugo: posts big blind $0.50
*** HOLE CARDS ***
Dealt to Lorpugo [Qc Th]
Ares656: folds
Uncalled bet ($0.25) returned to Lorpugo
Lorpugo collected $0.50 from pot
Lorpugo: doesn't show hand
*** SUMMARY ***
Total pot $0.50 | Rake $0
Seat 1: Ares656 (button) (small blind) folded before Flop
Seat 2: Lorpugo (big blind) collected ($0.50)


*********** # 134 **************
PokerStars Zoom Hand #235750826462: Hold'em No Limit ($0.25/$0.50) - 2022/04/26 14:59:23 ET
Table 'C Carinae' 2-max Seat #1 is the button
Seat 1: Lorpugo ($25 in chips)
Seat 2: MeryjanePL ($50 in chips)
Lorpugo: posts small blind $0.25
MeryjanePL: posts big blind $0.50
*** HOLE CARDS ***
Dealt to Lorpugo [4d 7h]
Lorpugo: folds
Uncalled bet ($0.25) returned to MeryjanePL
MeryjanePL collected $0.50 from pot
MeryjanePL: doesn't show hand
*** SUMMARY ***
Total pot $0.50 | Rake $0
Seat 1: Lorpugo (button) (small blind) folded before Flop
Seat 2: MeryjanePL (big blind) collected ($0.50)


*********** # 135 **************
PokerStars Zoom Hand #235750815090: Hold'em No Limit ($0.25/$0.50) - 2022/04/26 14:58:42 ET
Table 'C Carinae' 2-max Seat #1 is the button
Seat 1: Lorpugo ($22.21 in chips)
Seat 2: MeryjanePL ($64.13 in chips)
Lorpugo: posts small blind $0.25
MeryjanePL: posts big blind $0.50
*** HOLE CARDS ***
Dealt to Lorpugo [Ad Ks]
Lorpugo: raises $0.50 to $1
MeryjanePL: raises $3 to $4
Lorpugo: raises $18.21 to $22.21 and is all-in
MeryjanePL: calls $18.21
*** FLOP *** [Qc 2d Ac]
*** TURN *** [Qc 2d Ac] [Jh]
*** RIVER *** [Qc 2d Ac Jh] [3d]
*** SHOW DOWN ***
MeryjanePL: shows [As Ah] (three of a kind, Aces)
Lorpugo: shows [Ad Ks] (a pair of Aces)
MeryjanePL collected $43.67 from pot
*** SUMMARY ***
Total pot $44.42 | Rake $0.75
Board [Qc 2d Ac Jh 3d]
Seat 1: Lorpugo (button) (small blind) showed [Ad Ks] and lost with a pair of Aces
Seat 2: MeryjanePL (big blind) showed [As Ah] and won ($43.67) with three of a kind, Aces


*********** # 136 **************
PokerStars Zoom Hand #235750810982: Hold'em No Limit ($0.25/$0.50) - 2022/04/26 14:58:27 ET
Table 'C Carinae' 2-max Seat #1 is the button
Seat 1: Niclazzz ($37.18 in chips)
Seat 2: Lorpugo ($22.71 in chips)
Niclazzz: posts small blind $0.25
Lorpugo: posts big blind $0.50
*** HOLE CARDS ***
Dealt to Lorpugo [2s 8d]
Niclazzz: raises $1 to $1.50
Lorpugo: folds
Uncalled bet ($1) returned to Niclazzz
Niclazzz collected $1 from pot
Niclazzz: doesn't show hand
*** SUMMARY ***
Total pot $1 | Rake $0
Seat 1: Niclazzz (button) (small blind) collected ($1)
Seat 2: Lorpugo (big blind) folded before Flop


*********** # 137 **************
PokerStars Zoom Hand #235750804623: Hold'em No Limit ($0.25/$0.50) - 2022/04/26 14:58:04 ET
Table 'C Carinae' 2-max Seat #1 is the button
Seat 1: Lorpugo ($23.71 in chips)
Seat 2: 3bet4win9 ($44.37 in chips)
Lorpugo: posts small blind $0.25
3bet4win9: posts big blind $0.50
*** HOLE CARDS ***
Dealt to Lorpugo [6d Qh]
Lorpugo: raises $0.50 to $1
3bet4win9: raises $43.37 to $44.37 and is all-in
Lorpugo: folds
Uncalled bet ($43.37) returned to 3bet4win9
3bet4win9 collected $2 from pot
3bet4win9: doesn't show hand
3bet4win9 is disconnected
*** SUMMARY ***
Total pot $2 | Rake $0
Seat 1: Lorpugo (button) (small blind) folded before Flop
Seat 2: 3bet4win9 (big blind) collected ($2)


*********** # 138 **************
PokerStars Zoom Hand #235750802938: Hold'em No Limit ($0.25/$0.50) - 2022/04/26 14:57:58 ET
Table 'C Carinae' 2-max Seat #1 is the button
Seat 1: karakoK10 ($70.52 in chips)
Seat 2: Lorpugo ($23.46 in chips)
karakoK10: posts small blind $0.25
Lorpugo: posts big blind $0.50
*** HOLE CARDS ***
Dealt to Lorpugo [9c 2s]
karakoK10: folds
Uncalled bet ($0.25) returned to Lorpugo
Lorpugo collected $0.50 from pot
Lorpugo: doesn't show hand
*** SUMMARY ***
Total pot $0.50 | Rake $0
Seat 1: karakoK10 (button) (small blind) folded before Flop
Seat 2: Lorpugo (big blind) collected ($0.50)


*********** # 139 **************
PokerStars Zoom Hand #235750799519: Hold'em No Limit ($0.25/$0.50) - 2022/04/26 14:57:46 ET
Table 'C Carinae' 2-max Seat #1 is the button
Seat 1: Lorpugo ($22.96 in chips)
Seat 2: karakoK10 ($71.02 in chips)
Lorpugo: posts small blind $0.25
karakoK10: posts big blind $0.50
*** HOLE CARDS ***
Dealt to Lorpugo [5s 7d]
Lorpugo: raises $0.50 to $1
karakoK10: folds
Uncalled bet ($0.50) returned to Lorpugo
Lorpugo collected $1 from pot
Lorpugo: doesn't show hand
*** SUMMARY ***
Total pot $1 | Rake $0
Seat 1: Lorpugo (button) (small blind) collected ($1)
Seat 2: karakoK10 (big blind) folded before Flop


*********** # 140 **************
PokerStars Zoom Hand #235750779135: Hold'em No Limit ($0.25/$0.50) - 2022/04/26 14:56:33 ET
Table 'C Carinae' 2-max Seat #1 is the button
Seat 1: karakoK10 ($69.18 in chips)
Seat 2: Lorpugo ($25 in chips)
karakoK10: posts small blind $0.25
Lorpugo: posts big blind $0.50
*** HOLE CARDS ***
Dealt to Lorpugo [Ah 4h]
karakoK10: raises $0.75 to $1.25
Lorpugo: calls $0.75
*** FLOP *** [5c 5s 7d]
Lorpugo: checks
karakoK10: bets $0.79
Lorpugo: calls $0.79
*** TURN *** [5c 5s 7d] [8d]
Lorpugo: checks
karakoK10: checks
*** RIVER *** [5c 5s 7d 8d] [9h]
Lorpugo: checks
karakoK10: checks
*** SHOW DOWN ***
Lorpugo: shows [Ah 4h] (a pair of Fives)
karakoK10: shows [Jd Ad] (a pair of Fives - Ace+Jack kicker)
karakoK10 collected $3.88 from pot
*** SUMMARY ***
Total pot $4.08 | Rake $0.20
Board [5c 5s 7d 8d 9h]
Seat 1: karakoK10 (button) (small blind) showed [Jd Ad] and won ($3.88) with a pair of Fives
Seat 2: Lorpugo (big blind) showed [Ah 4h] and lost with a pair of Fives


*********** # 141 **************
PokerStars Zoom Hand #235732180958: Hold'em No Limit ($0.25/$0.50) - 2022/04/25 16:22:14 ET
Table 'C Carinae' 2-max Seat #1 is the button
Seat 1: Lorpugo ($29.97 in chips)
Seat 2: Dougpolk27997 ($50 in chips)
Lorpugo: posts small blind $0.25
Dougpolk27997: posts big blind $0.50
*** HOLE CARDS ***
Dealt to Lorpugo [As 8c]
Lorpugo: raises $0.60 to $1.10
Dougpolk27997: calls $0.60
*** FLOP *** [Qc Jd 5d]
Dougpolk27997: checks
Lorpugo: bets $0.50
Dougpolk27997: folds
Uncalled bet ($0.50) returned to Lorpugo
Lorpugo collected $2.09 from pot
Lorpugo: doesn't show hand
*** SUMMARY ***
Total pot $2.20 | Rake $0.11
Board [Qc Jd 5d]
Seat 1: Lorpugo (button) (small blind) collected ($2.09)
Seat 2: Dougpolk27997 (big blind) folded on the Flop


*********** # 142 **************
PokerStars Zoom Hand #235732148083: Hold'em No Limit ($0.25/$0.50) - 2022/04/25 16:21:18 ET
Table 'C Carinae' 2-max Seat #1 is the button
Seat 1: MeryjanePL ($50.77 in chips)
Seat 2: Lorpugo ($28.62 in chips)
MeryjanePL: posts small blind $0.25
Lorpugo: posts big blind $0.50
*** HOLE CARDS ***
Dealt to Lorpugo [Jc Th]
MeryjanePL: calls $0.25
Lorpugo: raises $1 to $1.50
MeryjanePL: calls $1
*** FLOP *** [6s Qs Qh]
Lorpugo: checks
MeryjanePL: checks
*** TURN *** [6s Qs Qh] [3c]
Lorpugo: bets $0.90
MeryjanePL: folds
Uncalled bet ($0.90) returned to Lorpugo
Lorpugo collected $2.85 from pot
Lorpugo: doesn't show hand
*** SUMMARY ***
Total pot $3 | Rake $0.15
Board [6s Qs Qh 3c]
Seat 1: MeryjanePL (button) (small blind) folded on the Turn
Seat 2: Lorpugo (big blind) collected ($2.85)


*********** # 143 **************
PokerStars Zoom Hand #235732137133: Hold'em No Limit ($0.25/$0.50) - 2022/04/25 16:20:53 ET
Table 'C Carinae' 2-max Seat #1 is the button
Seat 1: Lorpugo ($29.82 in chips)
Seat 2: lilyjackvs1 ($50 in chips)
Lorpugo: posts small blind $0.25
lilyjackvs1: posts big blind $0.50
*** HOLE CARDS ***
Dealt to Lorpugo [Jc 9h]
Lorpugo: raises $0.70 to $1.20
lilyjackvs1: raises $2.80 to $4
Lorpugo: folds
Uncalled bet ($2.80) returned to lilyjackvs1
lilyjackvs1 collected $2.40 from pot
lilyjackvs1: doesn't show hand
*** SUMMARY ***
Total pot $2.40 | Rake $0
Seat 1: Lorpugo (button) (small blind) folded before Flop
Seat 2: lilyjackvs1 (big blind) collected ($2.40)


*********** # 144 **************
PokerStars Zoom Hand #235732129575: Hold'em No Limit ($0.25/$0.50) - 2022/04/25 16:20:36 ET
Table 'C Carinae' 2-max Seat #1 is the button
Seat 1: Lorpugo ($29.32 in chips)
Seat 2: Dougpolk27997 ($51.55 in chips)
Lorpugo: posts small blind $0.25
Dougpolk27997: posts big blind $0.50
*** HOLE CARDS ***
Dealt to Lorpugo [Jc 5h]
Lorpugo: raises $0.55 to $1.05
Dougpolk27997: folds
Uncalled bet ($0.55) returned to Lorpugo
Lorpugo collected $1 from pot
Lorpugo: doesn't show hand
*** SUMMARY ***
Total pot $1 | Rake $0
Seat 1: Lorpugo (button) (small blind) collected ($1)
Seat 2: Dougpolk27997 (big blind) folded before Flop


*********** # 145 **************
PokerStars Zoom Hand #235732123866: Hold'em No Limit ($0.25/$0.50) - 2022/04/25 16:20:23 ET
Table 'C Carinae' 2-max Seat #1 is the button
Seat 1: Dougpolk27997 ($51.05 in chips)
Seat 2: Lorpugo ($29.82 in chips)
Dougpolk27997: posts small blind $0.25
Lorpugo: posts big blind $0.50
*** HOLE CARDS ***
Dealt to Lorpugo [5s 2h]
Dougpolk27997: raises $0.75 to $1.25
Lorpugo: folds
Uncalled bet ($0.75) returned to Dougpolk27997
Dougpolk27997 collected $1 from pot
Dougpolk27997: doesn't show hand
*** SUMMARY ***
Total pot $1 | Rake $0
Seat 1: Dougpolk27997 (button) (small blind) collected ($1)
Seat 2: Lorpugo (big blind) folded before Flop


*********** # 146 **************
PokerStars Zoom Hand #235732114864: Hold'em No Limit ($0.25/$0.50) - 2022/04/25 16:20:02 ET
Table 'C Carinae' 2-max Seat #1 is the button
Seat 1: Lorpugo ($30.87 in chips)
Seat 2: Dougpolk27997 ($50 in chips)
Lorpugo: posts small blind $0.25
Dougpolk27997: posts big blind $0.50
*** HOLE CARDS ***
Dealt to Lorpugo [4h 4d]
Lorpugo: raises $0.55 to $1.05
Dougpolk27997: raises $3.95 to $5
Lorpugo: folds
Uncalled bet ($3.95) returned to Dougpolk27997
Dougpolk27997 collected $2.10 from pot
Dougpolk27997: doesn't show hand
*** SUMMARY ***
Total pot $2.10 | Rake $0
Seat 1: Lorpugo (button) (small blind) folded before Flop
Seat 2: Dougpolk27997 (big blind) collected ($2.10)


*********** # 147 **************
PokerStars Zoom Hand #235732111801: Hold'em No Limit ($0.25/$0.50) - 2022/04/25 16:19:55 ET
Table 'C Carinae' 2-max Seat #1 is the button
Seat 1: Dougpolk27997 ($50 in chips)
Seat 2: Lorpugo ($30.62 in chips)
Dougpolk27997: posts small blind $0.25
Lorpugo: posts big blind $0.50
*** HOLE CARDS ***
Dealt to Lorpugo [5h Qc]
Dougpolk27997: folds
Uncalled bet ($0.25) returned to Lorpugo
Lorpugo collected $0.50 from pot
Lorpugo: doesn't show hand
*** SUMMARY ***
Total pot $0.50 | Rake $0
Seat 1: Dougpolk27997 (button) (small blind) folded before Flop
Seat 2: Lorpugo (big blind) collected ($0.50)


*********** # 148 **************
PokerStars Zoom Hand #235732095611: Hold'em No Limit ($0.25/$0.50) - 2022/04/25 16:19:17 ET
Table 'C Carinae' 2-max Seat #1 is the button
Seat 1: Lorpugo ($29.63 in chips)
Seat 2: MeryjanePL ($52.09 in chips)
Lorpugo: posts small blind $0.25
MeryjanePL: posts big blind $0.50
*** HOLE CARDS ***
Dealt to Lorpugo [As Ad]
Lorpugo: raises $0.60 to $1.10
MeryjanePL: calls $0.60
*** FLOP *** [5h 5s Tc]
MeryjanePL: checks
Lorpugo: bets $1
MeryjanePL: folds
Uncalled bet ($1) returned to Lorpugo
Lorpugo collected $2.09 from pot
Lorpugo: doesn't show hand
*** SUMMARY ***
Total pot $2.20 | Rake $0.11
Board [5h 5s Tc]
Seat 1: Lorpugo (button) (small blind) collected ($2.09)
Seat 2: MeryjanePL (big blind) folded on the Flop


*********** # 149 **************
PokerStars Zoom Hand #235732087566: Hold'em No Limit ($0.25/$0.50) - 2022/04/25 16:19:01 ET
Table 'C Carinae' 2-max Seat #1 is the button
Seat 1: Lorpugo ($29.13 in chips)
Seat 2: lucaslucas7 ($81.57 in chips)
Lorpugo: posts small blind $0.25
lucaslucas7: posts big blind $0.50
*** HOLE CARDS ***
Dealt to Lorpugo [Jh Jc]
Lorpugo: raises $0.75 to $1.25
lucaslucas7: folds
Uncalled bet ($0.75) returned to Lorpugo
Lorpugo collected $1 from pot
Lorpugo: doesn't show hand
*** SUMMARY ***
Total pot $1 | Rake $0
Seat 1: Lorpugo (button) (small blind) collected ($1)
Seat 2: lucaslucas7 (big blind) folded before Flop


*********** # 150 **************
PokerStars Zoom Hand #235732080242: Hold'em No Limit ($0.25/$0.50) - 2022/04/25 16:18:43 ET
Table 'C Carinae' 2-max Seat #1 is the button
Seat 1: samoooth ($162.89 in chips)
Seat 2: Lorpugo ($29.63 in chips)
samoooth: posts small blind $0.25
Lorpugo: posts big blind $0.50
*** HOLE CARDS ***
Dealt to Lorpugo [2s 8c]
samoooth: raises $0.75 to $1.25
Lorpugo: folds
Uncalled bet ($0.75) returned to samoooth
samoooth collected $1 from pot
samoooth: doesn't show hand
*** SUMMARY ***
Total pot $1 | Rake $0
Seat 1: samoooth (button) (small blind) collected ($1)
Seat 2: Lorpugo (big blind) folded before Flop


*********** # 151 **************
PokerStars Zoom Hand #235732038791: Hold'em No Limit ($0.25/$0.50) - 2022/04/25 16:17:08 ET
Table 'C Carinae' 2-max Seat #1 is the button
Seat 1: lilyjackvs1 ($63.15 in chips)
Seat 2: Lorpugo ($27.43 in chips)
lilyjackvs1: posts small blind $0.25
Lorpugo: posts big blind $0.50
*** HOLE CARDS ***
Dealt to Lorpugo [Ac 6c]
lilyjackvs1: raises $0.75 to $1.25
Lorpugo: calls $0.75
*** FLOP *** [Qh Ad 2c]
Lorpugo: checks
lilyjackvs1: bets $1.19
Lorpugo: calls $1.19
*** TURN *** [Qh Ad 2c] [6d]
Lorpugo: checks
lilyjackvs1: checks
*** RIVER *** [Qh Ad 2c 6d] [3s]
Lorpugo: bets $1.53
lilyjackvs1: folds
Uncalled bet ($1.53) returned to Lorpugo
Lorpugo collected $4.64 from pot
Lorpugo: doesn't show hand
*** SUMMARY ***
Total pot $4.88 | Rake $0.24
Board [Qh Ad 2c 6d 3s]
Seat 1: lilyjackvs1 (button) (small blind) folded on the River
Seat 2: Lorpugo (big blind) collected ($4.64)


*********** # 152 **************
PokerStars Zoom Hand #235732024442: Hold'em No Limit ($0.25/$0.50) - 2022/04/25 16:16:35 ET
Table 'C Carinae' 2-max Seat #1 is the button
Seat 1: Lorpugo ($25.09 in chips)
Seat 2: lilyjackvs1 ($65.75 in chips)
Lorpugo: posts small blind $0.25
lilyjackvs1: posts big blind $0.50
*** HOLE CARDS ***
Dealt to Lorpugo [6c 6d]
Lorpugo: raises $0.60 to $1.10
lilyjackvs1: calls $0.60
*** FLOP *** [8c 6h Ad]
lilyjackvs1: bets $1.50
Lorpugo: raises $2.50 to $4
lilyjackvs1: folds
Uncalled bet ($2.50) returned to Lorpugo
Lorpugo collected $4.94 from pot
Lorpugo: doesn't show hand
*** SUMMARY ***
Total pot $5.20 | Rake $0.26
Board [8c 6h Ad]
Seat 1: Lorpugo (button) (small blind) collected ($4.94)
Seat 2: lilyjackvs1 (big blind) folded on the Flop


*********** # 153 **************
PokerStars Zoom Hand #235732020528: Hold'em No Limit ($0.25/$0.50) - 2022/04/25 16:16:26 ET
Table 'C Carinae' 2-max Seat #1 is the button
Seat 1: sinzza5 ($41.29 in chips)
Seat 2: Lorpugo ($24.84 in chips)
sinzza5: posts small blind $0.25
Lorpugo: posts big blind $0.50
*** HOLE CARDS ***
Dealt to Lorpugo [Jc 7d]
sinzza5: folds
Uncalled bet ($0.25) returned to Lorpugo
Lorpugo collected $0.50 from pot
Lorpugo: doesn't show hand
sinzza5 is disconnected
*** SUMMARY ***
Total pot $0.50 | Rake $0
Seat 1: sinzza5 (button) (small blind) folded before Flop
Seat 2: Lorpugo (big blind) collected ($0.50)


*********** # 154 **************
PokerStars Zoom Hand #235732014311: Hold'em No Limit ($0.25/$0.50) - 2022/04/25 16:16:12 ET
Table 'C Carinae' 2-max Seat #1 is the button
Seat 1: mInImalIst9 ($51 in chips)
Seat 2: Lorpugo ($25.34 in chips)
mInImalIst9: posts small blind $0.25
Lorpugo: posts big blind $0.50
*** HOLE CARDS ***
Dealt to Lorpugo [6c 4h]
mInImalIst9: raises $0.75 to $1.25
Lorpugo: folds
Uncalled bet ($0.75) returned to mInImalIst9
mInImalIst9 collected $1 from pot
mInImalIst9: doesn't show hand
*** SUMMARY ***
Total pot $1 | Rake $0
Seat 1: mInImalIst9 (button) (small blind) collected ($1)
Seat 2: Lorpugo (big blind) folded before Flop


*********** # 155 **************
PokerStars Zoom Hand #235732000522: Hold'em No Limit ($0.25/$0.50) - 2022/04/25 16:15:40 ET
Table 'C Carinae' 2-max Seat #1 is the button
Seat 1: Lorpugo ($26.44 in chips)
Seat 2: mInImalIst9 ($50 in chips)
Lorpugo: posts small blind $0.25
mInImalIst9: posts big blind $0.50
*** HOLE CARDS ***
Dealt to Lorpugo [8d Qd]
Lorpugo: raises $0.60 to $1.10
mInImalIst9: raises $2.90 to $4
Lorpugo: folds
Uncalled bet ($2.90) returned to mInImalIst9
mInImalIst9 collected $2.20 from pot
mInImalIst9: doesn't show hand
*** SUMMARY ***
Total pot $2.20 | Rake $0
Seat 1: Lorpugo (button) (small blind) folded before Flop
Seat 2: mInImalIst9 (big blind) collected ($2.20)


*********** # 156 **************
PokerStars Zoom Hand #235731998383: Hold'em No Limit ($0.25/$0.50) - 2022/04/25 16:15:35 ET
Table 'C Carinae' 2-max Seat #1 is the button
Seat 1: samoooth ($57.39 in chips)
Seat 2: Lorpugo ($26.19 in chips)
samoooth: posts small blind $0.25
Lorpugo: posts big blind $0.50
*** HOLE CARDS ***
Dealt to Lorpugo [Ts 6h]
samoooth: folds
Uncalled bet ($0.25) returned to Lorpugo
Lorpugo collected $0.50 from pot
Lorpugo: doesn't show hand
*** SUMMARY ***
Total pot $0.50 | Rake $0
Seat 1: samoooth (button) (small blind) folded before Flop
Seat 2: Lorpugo (big blind) collected ($0.50)


*********** # 157 **************
PokerStars Zoom Hand #235731973087: Hold'em No Limit ($0.25/$0.50) - 2022/04/25 16:14:46 ET
Table 'C Carinae' 2-max Seat #1 is the button
Seat 1: erik1337 ($113.45 in chips)
Seat 2: Lorpugo ($19.41 in chips)
erik1337: posts small blind $0.25
Lorpugo: posts big blind $0.50
*** HOLE CARDS ***
Dealt to Lorpugo [Ts Kd]
erik1337: raises $0.60 to $1.10
Lorpugo: raises $2.20 to $3.30
erik1337: calls $2.20
*** FLOP *** [9d 5s 5c]
Lorpugo: bets $1.65
erik1337: raises $2.58 to $4.23
Lorpugo: raises $11.88 to $16.11 and is all-in
erik1337: folds
Uncalled bet ($11.88) returned to Lorpugo
Lorpugo collected $14.31 from pot
Lorpugo: doesn't show hand
*** SUMMARY ***
Total pot $15.06 | Rake $0.75
Board [9d 5s 5c]
Seat 1: erik1337 (button) (small blind) folded on the Flop
Seat 2: Lorpugo (big blind) collected ($14.31)


*********** # 158 **************
PokerStars Zoom Hand #235731948191: Hold'em No Limit ($0.25/$0.50) - 2022/04/25 16:13:47 ET
Table 'C Carinae' 2-max Seat #1 is the button
Seat 1: erik1337 ($115.23 in chips)
Seat 2: Lorpugo ($17.81 in chips)
erik1337: posts small blind $0.25
Lorpugo: posts big blind $0.50
*** HOLE CARDS ***
Dealt to Lorpugo [8c Th]
erik1337: raises $0.60 to $1.10
Lorpugo: calls $0.60
*** FLOP *** [Tc Td 7c]
Lorpugo: checks
erik1337: checks
*** TURN *** [Tc Td 7c] [Ah]
Lorpugo: checks
erik1337: checks
*** RIVER *** [Tc Td 7c Ah] [3h]
Lorpugo: bets $0.68
erik1337: calls $0.68
*** SHOW DOWN ***
Lorpugo: shows [8c Th] (three of a kind, Tens)
erik1337: mucks hand
Lorpugo collected $3.38 from pot
*** SUMMARY ***
Total pot $3.56 | Rake $0.18
Board [Tc Td 7c Ah 3h]
Seat 1: erik1337 (button) (small blind) mucked [Kh Qs]
Seat 2: Lorpugo (big blind) showed [8c Th] and won ($3.38) with three of a kind, Tens


*********** # 159 **************
PokerStars Zoom Hand #235731943668: Hold'em No Limit ($0.25/$0.50) - 2022/04/25 16:13:36 ET
Table 'C Carinae' 2-max Seat #1 is the button
Seat 1: Lorpugo ($17.31 in chips)
Seat 2: lilyjackvs1 ($70.30 in chips)
Lorpugo: posts small blind $0.25
lilyjackvs1: posts big blind $0.50
*** HOLE CARDS ***
Dealt to Lorpugo [Ad Th]
Lorpugo: raises $0.60 to $1.10
lilyjackvs1: folds
Uncalled bet ($0.60) returned to Lorpugo
Lorpugo collected $1 from pot
Lorpugo: doesn't show hand
*** SUMMARY ***
Total pot $1 | Rake $0
Seat 1: Lorpugo (button) (small blind) collected ($1)
Seat 2: lilyjackvs1 (big blind) folded before Flop


*********** # 160 **************
PokerStars Zoom Hand #235731924548: Hold'em No Limit ($0.25/$0.50) - 2022/04/25 16:12:51 ET
Table 'C Carinae' 2-max Seat #1 is the button
Seat 1: Lorpugo ($18.96 in chips)
Seat 2: EkimM1978 ($26.39 in chips)
Lorpugo: posts small blind $0.25
EkimM1978: posts big blind $0.50
*** HOLE CARDS ***
Dealt to Lorpugo [7h Ah]
Lorpugo: raises $0.65 to $1.15
EkimM1978: calls $0.65
*** FLOP *** [6h Jh Qd]
EkimM1978: checks
Lorpugo: checks
*** TURN *** [6h Jh Qd] [3c]
EkimM1978: bets $0.50
Lorpugo: calls $0.50
*** RIVER *** [6h Jh Qd 3c] [3d]
EkimM1978: bets $3
Lorpugo: folds
Uncalled bet ($3) returned to EkimM1978
EkimM1978 collected $3.10 from pot
EkimM1978: doesn't show hand
*** SUMMARY ***
Total pot $3.30 | Rake $0.20
Board [6h Jh Qd 3c 3d]
Seat 1: Lorpugo (button) (small blind) folded on the River
Seat 2: EkimM1978 (big blind) collected ($3.10)


*********** # 161 **************
PokerStars Zoom Hand #235731917799: Hold'em No Limit ($0.25/$0.50) - 2022/04/25 16:12:35 ET
Table 'C Carinae' 2-max Seat #1 is the button
Seat 1: Lorpugo ($18.46 in chips)
Seat 2: lucaslucas7 ($62.48 in chips)
Lorpugo: posts small blind $0.25
lucaslucas7: posts big blind $0.50
*** HOLE CARDS ***
Dealt to Lorpugo [Kh Kc]
Lorpugo: raises $0.60 to $1.10
lucaslucas7: folds
Uncalled bet ($0.60) returned to Lorpugo
Lorpugo collected $1 from pot
Lorpugo: doesn't show hand
*** SUMMARY ***
Total pot $1 | Rake $0
Seat 1: Lorpugo (button) (small blind) collected ($1)
Seat 2: lucaslucas7 (big blind) folded before Flop


*********** # 162 **************
PokerStars Zoom Hand #235731909255: Hold'em No Limit ($0.25/$0.50) - 2022/04/25 16:12:15 ET
Table 'C Carinae' 2-max Seat #1 is the button
Seat 1: Lorpugo ($17.96 in chips)
Seat 2: lucaslucas7 ($62.98 in chips)
Lorpugo: posts small blind $0.25
lucaslucas7: posts big blind $0.50
*** HOLE CARDS ***
Dealt to Lorpugo [Ts 7s]
Lorpugo: raises $0.65 to $1.15
lucaslucas7: folds
Uncalled bet ($0.65) returned to Lorpugo
Lorpugo collected $1 from pot
Lorpugo: doesn't show hand
*** SUMMARY ***
Total pot $1 | Rake $0
Seat 1: Lorpugo (button) (small blind) collected ($1)
Seat 2: lucaslucas7 (big blind) folded before Flop


*********** # 163 **************
PokerStars Zoom Hand #235731889151: Hold'em No Limit ($0.25/$0.50) - 2022/04/25 16:11:40 ET
Table 'C Carinae' 2-max Seat #1 is the button
Seat 1: sinzza5 ($43.65 in chips)
Seat 2: Lorpugo ($18.46 in chips)
sinzza5: posts small blind $0.25
Lorpugo: posts big blind $0.50
*** HOLE CARDS ***
Dealt to Lorpugo [Jc 3c]
sinzza5: raises $2 to $2.50
Lorpugo: folds
Uncalled bet ($2) returned to sinzza5
sinzza5 collected $1 from pot
sinzza5: doesn't show hand
*** SUMMARY ***
Total pot $1 | Rake $0
Seat 1: sinzza5 (button) (small blind) collected ($1)
Seat 2: Lorpugo (big blind) folded before Flop


*********** # 164 **************
PokerStars Zoom Hand #235731885165: Hold'em No Limit ($0.25/$0.50) - 2022/04/25 16:11:31 ET
Table 'C Carinae' 2-max Seat #1 is the button
Seat 1: OverCologne ($57.85 in chips)
Seat 2: Lorpugo ($18.96 in chips)
OverCologne: posts small blind $0.25
Lorpugo: posts big blind $0.50
*** HOLE CARDS ***
Dealt to Lorpugo [5c 7d]
OverCologne: raises $0.75 to $1.25
Lorpugo: folds
Uncalled bet ($0.75) returned to OverCologne
OverCologne collected $1 from pot
OverCologne: doesn't show hand
*** SUMMARY ***
Total pot $1 | Rake $0
Seat 1: OverCologne (button) (small blind) collected ($1)
Seat 2: Lorpugo (big blind) folded before Flop


*********** # 165 **************
PokerStars Zoom Hand #235731863004: Hold'em No Limit ($0.25/$0.50) - 2022/04/25 16:10:38 ET
Table 'C Carinae' 2-max Seat #1 is the button
Seat 1: Lorpugo ($23.56 in chips)
Seat 2: erik1337 ($108.94 in chips)
Lorpugo: posts small blind $0.25
erik1337: posts big blind $0.50
*** HOLE CARDS ***
Dealt to Lorpugo [6s 5c]
Lorpugo: raises $0.50 to $1
erik1337: calls $0.50
*** FLOP *** [Jc 8d 3d]
erik1337: checks
Lorpugo: checks
*** TURN *** [Jc 8d 3d] [2h]
erik1337: checks
Lorpugo: bets $1.55
erik1337: calls $1.55
*** RIVER *** [Jc 8d 3d 2h] [7d]
erik1337: checks
Lorpugo: bets $2.05
erik1337: raises $104.34 to $106.39 and is all-in
Lorpugo: folds
Uncalled bet ($104.34) returned to erik1337
erik1337 collected $8.74 from pot
erik1337: doesn't show hand
*** SUMMARY ***
Total pot $9.20 | Rake $0.46
Board [Jc 8d 3d 2h 7d]
Seat 1: Lorpugo (button) (small blind) folded on the River
Seat 2: erik1337 (big blind) collected ($8.74)


*********** # 166 **************
PokerStars Zoom Hand #235731837123: Hold'em No Limit ($0.25/$0.50) - 2022/04/25 16:09:37 ET
Table 'C Carinae' 2-max Seat #1 is the button
Seat 1: lucaslucas7 ($66.73 in chips)
Seat 2: Lorpugo ($22.21 in chips)
lucaslucas7: posts small blind $0.25
Lorpugo: posts big blind $0.50
*** HOLE CARDS ***
Dealt to Lorpugo [7h 5d]
lucaslucas7: calls $0.25
Lorpugo: checks
*** FLOP *** [5s Jc Ac]
Lorpugo: checks
lucaslucas7: checks
*** TURN *** [5s Jc Ac] [5h]
Lorpugo: bets $1
lucaslucas7: calls $1
*** RIVER *** [5s Jc Ac 5h] [Kc]
Lorpugo: checks
lucaslucas7: checks
*** SHOW DOWN ***
Lorpugo: shows [7h 5d] (three of a kind, Fives)
lucaslucas7: mucks hand
Lorpugo collected $2.85 from pot
*** SUMMARY ***
Total pot $3 | Rake $0.15
Board [5s Jc Ac 5h Kc]
Seat 1: lucaslucas7 (button) (small blind) mucked [Jd 2d]
Seat 2: Lorpugo (big blind) showed [7h 5d] and won ($2.85) with three of a kind, Fives


*********** # 167 **************
PokerStars Zoom Hand #235731828465: Hold'em No Limit ($0.25/$0.50) - 2022/04/25 16:09:16 ET
Table 'C Carinae' 2-max Seat #1 is the button
Seat 1: Lorpugo ($21.71 in chips)
Seat 2: lucaslucas7 ($90.24 in chips)
Lorpugo: posts small blind $0.25
lucaslucas7: posts big blind $0.50
*** HOLE CARDS ***
Dealt to Lorpugo [Ad 4h]
Lorpugo: raises $0.60 to $1.10
lucaslucas7: folds
Uncalled bet ($0.60) returned to Lorpugo
Lorpugo collected $1 from pot
Lorpugo: doesn't show hand
*** SUMMARY ***
Total pot $1 | Rake $0
Seat 1: Lorpugo (button) (small blind) collected ($1)
Seat 2: lucaslucas7 (big blind) folded before Flop


*********** # 168 **************
PokerStars Zoom Hand #235731821227: Hold'em No Limit ($0.25/$0.50) - 2022/04/25 16:08:59 ET
Table 'C Carinae' 2-max Seat #1 is the button
Seat 1: lucaslucas7 ($65.23 in chips)
Seat 2: Lorpugo ($22.21 in chips)
lucaslucas7: posts small blind $0.25
Lorpugo: posts big blind $0.50
*** HOLE CARDS ***
Dealt to Lorpugo [7s 2c]
lucaslucas7: raises $0.75 to $1.25
Lorpugo: folds
Uncalled bet ($0.75) returned to lucaslucas7
lucaslucas7 collected $1 from pot
lucaslucas7: doesn't show hand
*** SUMMARY ***
Total pot $1 | Rake $0
Seat 1: lucaslucas7 (button) (small blind) collected ($1)
Seat 2: Lorpugo (big blind) folded before Flop


*********** # 169 **************
PokerStars Zoom Hand #235731810310: Hold'em No Limit ($0.25/$0.50) - 2022/04/25 16:08:34 ET
Table 'C Carinae' 2-max Seat #1 is the button
Seat 1: Lorpugo ($23.46 in chips)
Seat 2: min_ace ($63.46 in chips)
Lorpugo: posts small blind $0.25
min_ace: posts big blind $0.50
*** HOLE CARDS ***
Dealt to Lorpugo [As 2c]
Lorpugo: raises $0.75 to $1.25
min_ace: calls $0.75
*** FLOP *** [3c 6s 5h]
min_ace: bets $1.19
Lorpugo: folds
Uncalled bet ($1.19) returned to min_ace
min_ace collected $2.38 from pot
min_ace: doesn't show hand
*** SUMMARY ***
Total pot $2.50 | Rake $0.12
Board [3c 6s 5h]
Seat 1: Lorpugo (button) (small blind) folded on the Flop
Seat 2: min_ace (big blind) collected ($2.38)


*********** # 170 **************
PokerStars Zoom Hand #235731802360: Hold'em No Limit ($0.25/$0.50) - 2022/04/25 16:08:15 ET
Table 'C Carinae' 2-max Seat #1 is the button
Seat 1: lilyjackvs1 ($50 in chips)
Seat 2: Lorpugo ($22.21 in chips)
lilyjackvs1: posts small blind $0.25
Lorpugo: posts big blind $0.50
*** HOLE CARDS ***
Dealt to Lorpugo [Tc 6c]
lilyjackvs1: raises $0.75 to $1.25
Lorpugo: raises $2.50 to $3.75
lilyjackvs1: folds
Uncalled bet ($2.50) returned to Lorpugo
Lorpugo collected $2.50 from pot
Lorpugo: doesn't show hand
*** SUMMARY ***
Total pot $2.50 | Rake $0
Seat 1: lilyjackvs1 (button) (small blind) folded before Flop
Seat 2: Lorpugo (big blind) collected ($2.50)


*********** # 171 **************
PokerStars Zoom Hand #235731795585: Hold'em No Limit ($0.25/$0.50) - 2022/04/25 16:07:59 ET
Table 'C Carinae' 2-max Seat #1 is the button
Seat 1: Lorpugo ($21.71 in chips)
Seat 2: zukmens ($66.48 in chips)
Lorpugo: posts small blind $0.25
zukmens: posts big blind $0.50
*** HOLE CARDS ***
Dealt to Lorpugo [Kd 2c]
Lorpugo: raises $0.75 to $1.25
zukmens: folds
Uncalled bet ($0.75) returned to Lorpugo
Lorpugo collected $1 from pot
Lorpugo: doesn't show hand
*** SUMMARY ***
Total pot $1 | Rake $0
Seat 1: Lorpugo (button) (small blind) collected ($1)
Seat 2: zukmens (big blind) folded before Flop


*********** # 172 **************
PokerStars Zoom Hand #235731788804: Hold'em No Limit ($0.25/$0.50) - 2022/04/25 16:07:43 ET
Table 'C Carinae' 2-max Seat #1 is the button
Seat 1: samoooth ($51.50 in chips)
Seat 2: Lorpugo ($20.71 in chips)
samoooth: posts small blind $0.25
Lorpugo: posts big blind $0.50
*** HOLE CARDS ***
Dealt to Lorpugo [Kd Kc]
samoooth: raises $0.50 to $1
Lorpugo: raises $2 to $3
samoooth: folds
Uncalled bet ($2) returned to Lorpugo
Lorpugo collected $2 from pot
Lorpugo: doesn't show hand
*** SUMMARY ***
Total pot $2 | Rake $0
Seat 1: samoooth (button) (small blind) folded before Flop
Seat 2: Lorpugo (big blind) collected ($2)


*********** # 173 **************
PokerStars Zoom Hand #235731784132: Hold'em No Limit ($0.25/$0.50) - 2022/04/25 16:07:32 ET
Table 'C Carinae' 2-max Seat #1 is the button
Seat 1: Lorpugo ($20.96 in chips)
Seat 2: lucaslucas7 ($91.57 in chips)
Lorpugo: posts small blind $0.25
lucaslucas7: posts big blind $0.50
*** HOLE CARDS ***
Dealt to Lorpugo [9h 3d]
Lorpugo: folds
Uncalled bet ($0.25) returned to lucaslucas7
lucaslucas7 collected $0.50 from pot
lucaslucas7: doesn't show hand
*** SUMMARY ***
Total pot $0.50 | Rake $0
Seat 1: Lorpugo (button) (small blind) folded before Flop
Seat 2: lucaslucas7 (big blind) collected ($0.50)


*********** # 174 **************
PokerStars Zoom Hand #235731769968: Hold'em No Limit ($0.25/$0.50) - 2022/04/25 16:06:59 ET
Table 'C Carinae' 2-max Seat #1 is the button
Seat 1: Lorpugo ($22.16 in chips)
Seat 2: min_ace ($60.48 in chips)
Lorpugo: posts small blind $0.25
min_ace: posts big blind $0.50
*** HOLE CARDS ***
Dealt to Lorpugo [8h Ts]
Lorpugo: raises $0.70 to $1.20
min_ace: calls $0.70
*** FLOP *** [2h 5c Kc]
min_ace: bets $1.14
Lorpugo: folds
Uncalled bet ($1.14) returned to min_ace
min_ace collected $2.28 from pot
min_ace: doesn't show hand
*** SUMMARY ***
Total pot $2.40 | Rake $0.12
Board [2h 5c Kc]
Seat 1: Lorpugo (button) (small blind) folded on the Flop
Seat 2: min_ace (big blind) collected ($2.28)


*********** # 175 **************
PokerStars Zoom Hand #235731759517: Hold'em No Limit ($0.25/$0.50) - 2022/04/25 16:06:34 ET
Table 'C Carinae' 2-max Seat #1 is the button
Seat 1: lucaslucas7 ($90.17 in chips)
Seat 2: Lorpugo ($22.66 in chips)
lucaslucas7: posts small blind $0.25
Lorpugo: posts big blind $0.50
*** HOLE CARDS ***
Dealt to Lorpugo [4d Kc]
lucaslucas7: calls $0.25
Lorpugo: checks
*** FLOP *** [Qd 5h 8c]
Lorpugo: checks
lucaslucas7: bets $0.50
Lorpugo: folds
Uncalled bet ($0.50) returned to lucaslucas7
lucaslucas7 collected $0.95 from pot
lucaslucas7: doesn't show hand
*** SUMMARY ***
Total pot $1 | Rake $0.05
Board [Qd 5h 8c]
Seat 1: lucaslucas7 (button) (small blind) collected ($0.95)
Seat 2: Lorpugo (big blind) folded on the Flop


*********** # 176 **************
PokerStars Zoom Hand #235731753829: Hold'em No Limit ($0.25/$0.50) - 2022/04/25 16:06:20 ET
Table 'C Carinae' 2-max Seat #1 is the button
Seat 1: OverCologne ($89.80 in chips)
Seat 2: Lorpugo ($23.16 in chips)
OverCologne: posts small blind $0.25
Lorpugo: posts big blind $0.50
*** HOLE CARDS ***
Dealt to Lorpugo [4s Ts]
OverCologne: raises $0.75 to $1.25
Lorpugo: folds
Uncalled bet ($0.75) returned to OverCologne
OverCologne collected $1 from pot
OverCologne: doesn't show hand
*** SUMMARY ***
Total pot $1 | Rake $0
Seat 1: OverCologne (button) (small blind) collected ($1)
Seat 2: Lorpugo (big blind) folded before Flop


*********** # 177 **************
PokerStars Zoom Hand #235731751322: Hold'em No Limit ($0.25/$0.50) - 2022/04/25 16:06:14 ET
Table 'C Carinae' 2-max Seat #1 is the button
Seat 1: erik1337 ($50.25 in chips)
Seat 2: Lorpugo ($23.66 in chips)
erik1337: posts small blind $0.25
Lorpugo: posts big blind $0.50
*** HOLE CARDS ***
Dealt to Lorpugo [5h 2d]
erik1337: raises $0.60 to $1.10
Lorpugo: folds
Uncalled bet ($0.60) returned to erik1337
erik1337 collected $1 from pot
erik1337: doesn't show hand
*** SUMMARY ***
Total pot $1 | Rake $0
Seat 1: erik1337 (button) (small blind) collected ($1)
Seat 2: Lorpugo (big blind) folded before Flop


*********** # 178 **************
PokerStars Zoom Hand #235731739403: Hold'em No Limit ($0.25/$0.50) - 2022/04/25 16:05:47 ET
Table 'C Carinae' 2-max Seat #1 is the button
Seat 1: Lorpugo ($24.82 in chips)
Seat 2: sinzza5 ($49.21 in chips)
Lorpugo: posts small blind $0.25
sinzza5: posts big blind $0.50
*** HOLE CARDS ***
Dealt to Lorpugo [Ac 8s]
Lorpugo: raises $0.66 to $1.16
sinzza5: calls $0.66
*** FLOP *** [Th 9d 2c]
sinzza5: checks
Lorpugo: checks
*** TURN *** [Th 9d 2c] [6d]
sinzza5: checks
Lorpugo: checks
*** RIVER *** [Th 9d 2c 6d] [8d]
sinzza5: bets $2.20
Lorpugo: folds
Uncalled bet ($2.20) returned to sinzza5
sinzza5 collected $2.20 from pot
sinzza5: doesn't show hand
*** SUMMARY ***
Total pot $2.32 | Rake $0.12
Board [Th 9d 2c 6d 8d]
Seat 1: Lorpugo (button) (small blind) folded on the River
Seat 2: sinzza5 (big blind) collected ($2.20)


*********** # 179 **************
PokerStars Zoom Hand #235731733324: Hold'em No Limit ($0.25/$0.50) - 2022/04/25 16:05:32 ET
Table 'C Carinae' 2-max Seat #1 is the button
Seat 1: Lorpugo ($24.32 in chips)
Seat 2: lilyjackvs1 ($50 in chips)
Lorpugo: posts small blind $0.25
lilyjackvs1: posts big blind $0.50
*** HOLE CARDS ***
Dealt to Lorpugo [Js 5s]
Lorpugo: raises $0.60 to $1.10
lilyjackvs1: folds
Uncalled bet ($0.60) returned to Lorpugo
Lorpugo collected $1 from pot
Lorpugo: doesn't show hand
*** SUMMARY ***
Total pot $1 | Rake $0
Seat 1: Lorpugo (button) (small blind) collected ($1)
Seat 2: lilyjackvs1 (big blind) folded before Flop


*********** # 180 **************
PokerStars Zoom Hand #235731727303: Hold'em No Limit ($0.25/$0.50) - 2022/04/25 16:05:18 ET
Table 'C Carinae' 2-max Seat #1 is the button
Seat 1: Lorpugo ($23.82 in chips)
Seat 2: ZenMisery ($50.63 in chips)
Lorpugo: posts small blind $0.25
ZenMisery: posts big blind $0.50
*** HOLE CARDS ***
Dealt to Lorpugo [Qh Th]
Lorpugo: raises $0.75 to $1.25
ZenMisery: folds
Uncalled bet ($0.75) returned to Lorpugo
Lorpugo collected $1 from pot
Lorpugo: doesn't show hand
*** SUMMARY ***
Total pot $1 | Rake $0
Seat 1: Lorpugo (button) (small blind) collected ($1)
Seat 2: ZenMisery (big blind) folded before Flop


*********** # 181 **************
PokerStars Zoom Hand #235731723463: Hold'em No Limit ($0.25/$0.50) - 2022/04/25 16:05:09 ET
Table 'C Carinae' 2-max Seat #1 is the button
Seat 1: Lorpugo ($23.32 in chips)
Seat 2: OverCologne ($93.04 in chips)
Lorpugo: posts small blind $0.25
OverCologne: posts big blind $0.50
*** HOLE CARDS ***
Dealt to Lorpugo [2d 9d]
Lorpugo: raises $0.75 to $1.25
OverCologne: folds
Uncalled bet ($0.75) returned to Lorpugo
Lorpugo collected $1 from pot
Lorpugo: doesn't show hand
*** SUMMARY ***
Total pot $1 | Rake $0
Seat 1: Lorpugo (button) (small blind) collected ($1)
Seat 2: OverCologne (big blind) folded before Flop


*********** # 182 **************
PokerStars Zoom Hand #235731710364: Hold'em No Limit ($0.25/$0.50) - 2022/04/25 16:04:39 ET
Table 'C Carinae' 2-max Seat #1 is the button
Seat 1: min_ace ($32.47 in chips)
Seat 2: Lorpugo ($20.24 in chips)
min_ace: posts small blind $0.25
Lorpugo: posts big blind $0.50
*** HOLE CARDS ***
Dealt to Lorpugo [9h 5h]
min_ace: raises $1 to $1.50
Lorpugo: calls $1
*** FLOP *** [7s 4d 8s]
Lorpugo: checks
min_ace: bets $1.92
Lorpugo: calls $1.92
*** TURN *** [7s 4d 8s] [Js]
Lorpugo: checks
min_ace: checks
*** RIVER *** [7s 4d 8s Js] [Td]
Lorpugo: bets $3.50
min_ace: folds
Uncalled bet ($3.50) returned to Lorpugo
Lorpugo collected $6.50 from pot
Lorpugo: doesn't show hand
min_ace is disconnected
*** SUMMARY ***
Total pot $6.84 | Rake $0.34
Board [7s 4d 8s Js Td]
Seat 1: min_ace (button) (small blind) folded on the River
Seat 2: Lorpugo (big blind) collected ($6.50)


*********** # 183 **************
PokerStars Zoom Hand #235731707912: Hold'em No Limit ($0.25/$0.50) - 2022/04/25 16:04:33 ET
Table 'C Carinae' 2-max Seat #1 is the button
Seat 1: min_ace ($32.72 in chips)
Seat 2: Lorpugo ($19.99 in chips)
min_ace: posts small blind $0.25
Lorpugo: posts big blind $0.50
*** HOLE CARDS ***
Dealt to Lorpugo [2h 8c]
min_ace: folds
Uncalled bet ($0.25) returned to Lorpugo
Lorpugo collected $0.50 from pot
Lorpugo: doesn't show hand
min_ace is disconnected
*** SUMMARY ***
Total pot $0.50 | Rake $0
Seat 1: min_ace (button) (small blind) folded before Flop
Seat 2: Lorpugo (big blind) collected ($0.50)


*********** # 184 **************
PokerStars Zoom Hand #235731704850: Hold'em No Limit ($0.25/$0.50) - 2022/04/25 16:04:26 ET
Table 'C Carinae' 2-max Seat #1 is the button
Seat 1: Lorpugo ($19.49 in chips)
Seat 2: FradiMob ($50 in chips)
Lorpugo: posts small blind $0.25
FradiMob: posts big blind $0.50
*** HOLE CARDS ***
Dealt to Lorpugo [9h 6s]
Lorpugo: raises $0.50 to $1
FradiMob: folds
Uncalled bet ($0.50) returned to Lorpugo
Lorpugo collected $1 from pot
Lorpugo: doesn't show hand
*** SUMMARY ***
Total pot $1 | Rake $0
Seat 1: Lorpugo (button) (small blind) collected ($1)
Seat 2: FradiMob (big blind) folded before Flop


*********** # 185 **************
PokerStars Zoom Hand #235731697310: Hold'em No Limit ($0.25/$0.50) - 2022/04/25 16:04:08 ET
Table 'C Carinae' 2-max Seat #1 is the button
Seat 1: ZenMisery ($50.25 in chips)
Seat 2: Lorpugo ($18.24 in chips)
ZenMisery: posts small blind $0.25
Lorpugo: posts big blind $0.50
*** HOLE CARDS ***
Dealt to Lorpugo [Ah Js]
ZenMisery: raises $0.75 to $1.25
Lorpugo: raises $16.99 to $18.24 and is all-in
ZenMisery: folds
Uncalled bet ($16.99) returned to Lorpugo
Lorpugo collected $2.50 from pot
Lorpugo: doesn't show hand
*** SUMMARY ***
Total pot $2.50 | Rake $0
Seat 1: ZenMisery (button) (small blind) folded before Flop
Seat 2: Lorpugo (big blind) collected ($2.50)


*********** # 186 **************
PokerStars Zoom Hand #235731693047: Hold'em No Limit ($0.25/$0.50) - 2022/04/25 16:03:58 ET
Table 'C Carinae' 2-max Seat #1 is the button
Seat 1: Lorpugo ($18.49 in chips)
Seat 2: ZenMisery ($50 in chips)
Lorpugo: posts small blind $0.25
ZenMisery: posts big blind $0.50
*** HOLE CARDS ***
Dealt to Lorpugo [9c 4h]
Lorpugo: folds
Uncalled bet ($0.25) returned to ZenMisery
ZenMisery collected $0.50 from pot
ZenMisery: doesn't show hand
*** SUMMARY ***
Total pot $0.50 | Rake $0
Seat 1: Lorpugo (button) (small blind) folded before Flop
Seat 2: ZenMisery (big blind) collected ($0.50)


*********** # 187 **************
PokerStars Zoom Hand #235731686536: Hold'em No Limit ($0.25/$0.50) - 2022/04/25 16:03:43 ET
Table 'C Carinae' 2-max Seat #1 is the button
Seat 1: zukmens ($25.25 in chips)
Seat 2: Lorpugo ($18.99 in chips)
zukmens: posts small blind $0.25
Lorpugo: posts big blind $0.50
*** HOLE CARDS ***
Dealt to Lorpugo [4d Jh]
zukmens: raises $1 to $1.50
Lorpugo: folds
Uncalled bet ($1) returned to zukmens
zukmens collected $1 from pot
zukmens: doesn't show hand
*** SUMMARY ***
Total pot $1 | Rake $0
Seat 1: zukmens (button) (small blind) collected ($1)
Seat 2: Lorpugo (big blind) folded before Flop


*********** # 188 **************
PokerStars Zoom Hand #235731677904: Hold'em No Limit ($0.25/$0.50) - 2022/04/25 16:03:23 ET
Table 'C Carinae' 2-max Seat #1 is the button
Seat 1: Lorpugo ($18.09 in chips)
Seat 2: OverCologne ($69.16 in chips)
Lorpugo: posts small blind $0.25
OverCologne: posts big blind $0.50
*** HOLE CARDS ***
Dealt to Lorpugo [6s 6c]
Lorpugo: raises $0.50 to $1
OverCologne: calls $0.50
*** FLOP *** [7h 3h As]
OverCologne: checks
Lorpugo: bets $0.63
OverCologne: folds
Uncalled bet ($0.63) returned to Lorpugo
Lorpugo collected $1.90 from pot
Lorpugo: doesn't show hand
*** SUMMARY ***
Total pot $2 | Rake $0.10
Board [7h 3h As]
Seat 1: Lorpugo (button) (small blind) collected ($1.90)
Seat 2: OverCologne (big blind) folded on the Flop


*********** # 189 **************
PokerStars Zoom Hand #235731671901: Hold'em No Limit ($0.25/$0.50) - 2022/04/25 16:03:09 ET
Table 'C Carinae' 2-max Seat #1 is the button
Seat 1: OverCologne ($84.19 in chips)
Seat 2: Lorpugo ($18.59 in chips)
OverCologne: posts small blind $0.25
Lorpugo: posts big blind $0.50
*** HOLE CARDS ***
Dealt to Lorpugo [Qh 3d]
OverCologne: raises $0.75 to $1.25
Lorpugo: folds
Uncalled bet ($0.75) returned to OverCologne
OverCologne collected $1 from pot
OverCologne: doesn't show hand
*** SUMMARY ***
Total pot $1 | Rake $0
Seat 1: OverCologne (button) (small blind) collected ($1)
Seat 2: Lorpugo (big blind) folded before Flop


*********** # 190 **************
PokerStars Zoom Hand #235731666939: Hold'em No Limit ($0.25/$0.50) - 2022/04/25 16:02:57 ET
Table 'C Carinae' 2-max Seat #1 is the button
Seat 1: Lorpugo ($19.59 in chips)
Seat 2: OverCologne ($83.19 in chips)
Lorpugo: posts small blind $0.25
OverCologne: posts big blind $0.50
*** HOLE CARDS ***
Dealt to Lorpugo [9s 4s]
Lorpugo: raises $0.50 to $1
OverCologne: raises $3 to $4
Lorpugo: folds
Uncalled bet ($3) returned to OverCologne
OverCologne collected $2 from pot
OverCologne: doesn't show hand
*** SUMMARY ***
Total pot $2 | Rake $0
Seat 1: Lorpugo (button) (small blind) folded before Flop
Seat 2: OverCologne (big blind) collected ($2)


*********** # 191 **************
PokerStars Zoom Hand #235731646125: Hold'em No Limit ($0.25/$0.50) - 2022/04/25 16:02:07 ET
Table 'C Carinae' 2-max Seat #1 is the button
Seat 1: OverCologne ($81.16 in chips)
Seat 2: Lorpugo ($21.84 in chips)
OverCologne: posts small blind $0.25
Lorpugo: posts big blind $0.50
*** HOLE CARDS ***
Dealt to Lorpugo [6s 7d]
OverCologne: raises $0.75 to $1.25
Lorpugo: calls $0.75
*** FLOP *** [Ts 7h 9d]
Lorpugo: bets $0.50
OverCologne: raises $0.50 to $1
Lorpugo: calls $0.50
*** TURN *** [Ts 7h 9d] [Qc]
Lorpugo: checks
OverCologne: checks
*** RIVER *** [Ts 7h 9d Qc] [3d]
Lorpugo: checks
OverCologne: bets $1.25
Lorpugo: folds
Uncalled bet ($1.25) returned to OverCologne
OverCologne collected $4.28 from pot
OverCologne: doesn't show hand
*** SUMMARY ***
Total pot $4.50 | Rake $0.22
Board [Ts 7h 9d Qc 3d]
Seat 1: OverCologne (button) (small blind) collected ($4.28)
Seat 2: Lorpugo (big blind) folded on the River


*********** # 192 **************
PokerStars Zoom Hand #235731613230: Hold'em No Limit ($0.25/$0.50) - 2022/04/25 16:00:42 ET
Table 'C Carinae' 2-max Seat #1 is the button
Seat 1: Lorpugo ($27.74 in chips)
Seat 2: lucaslucas7 ($66.12 in chips)
Lorpugo: posts small blind $0.25
lucaslucas7: posts big blind $0.50
*** HOLE CARDS ***
Dealt to Lorpugo [Jd 8c]
Lorpugo: raises $0.60 to $1.10
lucaslucas7: calls $0.60
*** FLOP *** [Qc 4h 9c]
lucaslucas7: checks
Lorpugo: bets $0.65
lucaslucas7: calls $0.65
*** TURN *** [Qc 4h 9c] [7h]
lucaslucas7: checks
Lorpugo: bets $1
lucaslucas7: calls $1
*** RIVER *** [Qc 4h 9c 7h] [Kh]
lucaslucas7: checks
Lorpugo: bets $3.15
lucaslucas7: calls $3.15
*** SHOW DOWN ***
Lorpugo: shows [Jd 8c] (high card King)
lucaslucas7: shows [8d Qd] (a pair of Queens)
lucaslucas7 collected $11.21 from pot
*** SUMMARY ***
Total pot $11.80 | Rake $0.59
Board [Qc 4h 9c 7h Kh]
Seat 1: Lorpugo (button) (small blind) showed [Jd 8c] and lost with high card King
Seat 2: lucaslucas7 (big blind) showed [8d Qd] and won ($11.21) with a pair of Queens


*********** # 193 **************
PokerStars Zoom Hand #235731594267: Hold'em No Limit ($0.25/$0.50) - 2022/04/25 16:00:02 ET
Table 'C Carinae' 2-max Seat #1 is the button
Seat 1: Lorpugo ($28.79 in chips)
Seat 2: Dougpolk27997 ($50 in chips)
Lorpugo: posts small blind $0.25
Dougpolk27997: posts big blind $0.50
*** HOLE CARDS ***
Dealt to Lorpugo [4h 4c]
Lorpugo: raises $0.55 to $1.05
Dougpolk27997: calls $0.55
*** FLOP *** [Qh Th 6c]
Dougpolk27997: checks
Lorpugo: checks
*** TURN *** [Qh Th 6c] [3s]
Dougpolk27997: bets $1.32
Lorpugo: folds
Uncalled bet ($1.32) returned to Dougpolk27997
Dougpolk27997 collected $2 from pot
Dougpolk27997: doesn't show hand
*** SUMMARY ***
Total pot $2.10 | Rake $0.10
Board [Qh Th 6c 3s]
Seat 1: Lorpugo (button) (small blind) folded on the Turn
Seat 2: Dougpolk27997 (big blind) collected ($2)


*********** # 194 **************
PokerStars Zoom Hand #235731591012: Hold'em No Limit ($0.25/$0.50) - 2022/04/25 15:59:52 ET
Table 'C Carinae' 2-max Seat #1 is the button
Seat 1: min_ace ($34.67 in chips)
Seat 2: Lorpugo ($28.54 in chips)
min_ace: posts small blind $0.25
Lorpugo: posts big blind $0.50
*** HOLE CARDS ***
Dealt to Lorpugo [2d 4h]
min_ace: folds
Uncalled bet ($0.25) returned to Lorpugo
Lorpugo collected $0.50 from pot
Lorpugo: doesn't show hand
min_ace is disconnected
*** SUMMARY ***
Total pot $0.50 | Rake $0
Seat 1: min_ace (button) (small blind) folded before Flop
Seat 2: Lorpugo (big blind) collected ($0.50)


*********** # 195 **************
PokerStars Zoom Hand #235731574744: Hold'em No Limit ($0.25/$0.50) - 2022/04/25 15:59:01 ET
Table 'C Carinae' 2-max Seat #1 is the button
Seat 1: sinzza5 ($56.24 in chips)
Seat 2: Lorpugo ($26.34 in chips)
sinzza5: posts small blind $0.25
Lorpugo: posts big blind $0.50
*** HOLE CARDS ***
Dealt to Lorpugo [Ah Ad]
sinzza5: calls $0.25
Lorpugo: raises $1 to $1.50
sinzza5: calls $1
*** FLOP *** [4s 2d Kd]
Lorpugo: bets $0.94
sinzza5: calls $0.94
*** TURN *** [4s 2d Kd] [Ac]
Lorpugo: bets $2
sinzza5: folds
Uncalled bet ($2) returned to Lorpugo
Lorpugo collected $4.64 from pot
Lorpugo: doesn't show hand
sinzza5 is disconnected
*** SUMMARY ***
Total pot $4.88 | Rake $0.24
Board [4s 2d Kd Ac]
Seat 1: sinzza5 (button) (small blind) folded on the Turn
Seat 2: Lorpugo (big blind) collected ($4.64)


*********** # 196 **************
PokerStars Zoom Hand #235731562989: Hold'em No Limit ($0.25/$0.50) - 2022/04/25 15:58:24 ET
Table 'C Carinae' 2-max Seat #1 is the button
Seat 1: Lorpugo ($27.39 in chips)
Seat 2: sinzza5 ($55.29 in chips)
Lorpugo: posts small blind $0.25
sinzza5: posts big blind $0.50
*** HOLE CARDS ***
Dealt to Lorpugo [3s Qh]
Lorpugo: raises $0.55 to $1.05
sinzza5: calls $0.55
*** FLOP *** [9h Kh Ks]
sinzza5: checks
Lorpugo: checks
*** TURN *** [9h Kh Ks] [5c]
sinzza5: bets $2
Lorpugo: folds
Uncalled bet ($2) returned to sinzza5
sinzza5 collected $2 from pot
sinzza5: doesn't show hand
*** SUMMARY ***
Total pot $2.10 | Rake $0.10
Board [9h Kh Ks 5c]
Seat 1: Lorpugo (button) (small blind) folded on the Turn
Seat 2: sinzza5 (big blind) collected ($2)


*********** # 197 **************
PokerStars Zoom Hand #235731543456: Hold'em No Limit ($0.25/$0.50) - 2022/04/25 15:57:21 ET
Table 'C Carinae' 2-max Seat #1 is the button
Seat 1: OverCologne ($54.67 in chips)
Seat 2: Lorpugo ($25.50 in chips)
OverCologne: posts small blind $0.25
Lorpugo: posts big blind $0.50
*** HOLE CARDS ***
Dealt to Lorpugo [8c 6h]
OverCologne: raises $0.75 to $1.25
Lorpugo: calls $0.75
*** FLOP *** [Tc 6s 5h]
Lorpugo: checks
OverCologne: checks
*** TURN *** [Tc 6s 5h] [6d]
Lorpugo: bets $0.85
OverCologne: calls $0.85
*** RIVER *** [Tc 6s 5h 6d] [Kd]
Lorpugo: bets $3.99
OverCologne: folds
Uncalled bet ($3.99) returned to Lorpugo
Lorpugo collected $3.99 from pot
Lorpugo: doesn't show hand
*** SUMMARY ***
Total pot $4.20 | Rake $0.21
Board [Tc 6s 5h 6d Kd]
Seat 1: OverCologne (button) (small blind) folded on the River
Seat 2: Lorpugo (big blind) collected ($3.99)


*********** # 198 **************
PokerStars Zoom Hand #235731540674: Hold'em No Limit ($0.25/$0.50) - 2022/04/25 15:57:12 ET
Table 'C Carinae' 2-max Seat #1 is the button
Seat 1: Lorpugo ($25 in chips)
Seat 2: Namlessss ($49.25 in chips)
Lorpugo: posts small blind $0.25
Namlessss: posts big blind $0.50
*** HOLE CARDS ***
Dealt to Lorpugo [Qs 5h]
Lorpugo: raises $0.50 to $1
Namlessss: folds
Uncalled bet ($0.50) returned to Lorpugo
Lorpugo collected $1 from pot
Lorpugo: doesn't show hand
Namlessss is disconnected
*** SUMMARY ***
Total pot $1 | Rake $0
Seat 1: Lorpugo (button) (small blind) collected ($1)
Seat 2: Namlessss (big blind) folded before Flop


*********** # 199 **************
PokerStars Zoom Hand #235731538398: Hold'em No Limit ($0.25/$0.50) - 2022/04/25 15:57:05 ET
Table 'C Carinae' 2-max Seat #1 is the button
Seat 1: Namlessss ($49.50 in chips)
Seat 2: Lorpugo ($24.75 in chips)
Namlessss: posts small blind $0.25
Lorpugo: posts big blind $0.50
*** HOLE CARDS ***
Dealt to Lorpugo [7h 4d]
Namlessss: folds
Uncalled bet ($0.25) returned to Lorpugo
Lorpugo collected $0.50 from pot
Lorpugo: doesn't show hand
Namlessss is disconnected
*** SUMMARY ***
Total pot $0.50 | Rake $0
Seat 1: Namlessss (button) (small blind) folded before Flop
Seat 2: Lorpugo (big blind) collected ($0.50)


*********** # 200 **************
PokerStars Zoom Hand #235731535039: Hold'em No Limit ($0.25/$0.50) - 2022/04/25 15:56:54 ET
Table 'C Carinae' 2-max Seat #1 is the button
Seat 1: Lorpugo ($24.25 in chips)
Seat 2: Namlessss ($50 in chips)
Lorpugo: posts small blind $0.25
Namlessss: posts big blind $0.50
*** HOLE CARDS ***
Dealt to Lorpugo [3h 2h]
Lorpugo: raises $0.50 to $1
Namlessss: folds
Uncalled bet ($0.50) returned to Lorpugo
Lorpugo collected $1 from pot
Lorpugo: doesn't show hand
Namlessss is disconnected
*** SUMMARY ***
Total pot $1 | Rake $0
Seat 1: Lorpugo (button) (small blind) collected ($1)
Seat 2: Namlessss (big blind) folded before Flop